`word`	`word`abridgment sự giảm bớt sự cô gọn sự tóm tắt; bài tóm tắt sách sách tóm tắt- sự hạn chế sự giảm bớt
a	adfsf
aard-wolf	wulf/* danh từ- (động vật học) chó sói đất (nam phi)wulf/* danh từ- (động vật học) chó sói đất (nam phi)
aardvark	@aardvark* danh từ- (động vật) lợn đất
aardvarks	@aardvark* danh từ- (động vật) lợn đất
aardwolf	@aardwolf* danh từ- &lt;động&gt; chó sói đất (nam phi)
aardwolves	@aardwolf* danh từ- &lt;động&gt; chó sói đất (nam phi)
aasvogel	@aasvogel /''ɑ:sfougəl/* danh từ- (động vật học) con kên kên (nam phi)
ab	@ab- (vt của able-bodied seaman) thủy thủ hạng nhất- (vt của bachelor of arts) cử nhân văn chương
aba	@aba /''ɑ:bə/* danh từ- áo aba (áo ngoài giống hình cái túi người a-rập)
abac	bản đồ tính '<c><f><i><n><q>@abac abacus- bàn tính toán đồ bản đồ tính
abaca	@abaca* danh từ- vải dệt bằng tơ chuối abaca ở philipin- cây chuối abaca
abaci	đỉnh cột@abacus- (tech) bàn toán số nhiều abaci abacuses- bàn tính=to move counters of an abacus; to work an abacus+ tính bằng bàn tính gảy bàn tính- (kiến trúc)- đầu cột đỉnh cột</q></n></i></f></c><c><f><i><n><q>@abacus /''æbəkəs/* danh từ số nhiều abaci abacuses- bàn tính=to move counters of an abacus; to work an abacus+ tính bằng bàn tính gảy bàn tính- (kiến trúc)- đầu cột đỉnh cột@abacus- (tech) bàn toán
abacist	@abacist* danh từ- người gãy bàn phím- người kế toán
aback	ngạc nhiên=to be taken aback by the news+ sửng sốt vì cái tin đó trở lại phía sau=to stand aback from+ đứng lùi lại để tránh- (hàng hải) bị thổi ép vào cột buồm (buồm)=to be taken aback+ (hàng hải) bị gió thổi ép vào cột buồm- (nghĩa bóng) sửng sốt ngạc nhiên=to be taken aback by the news+ sửng sốt vì cái tin đó
abacterial	@abacterial* tính từ- không do vi khuẩn gây ra
abaction	@abaction* danh từ- (từ pháp) việc gia súc bị bắt trộm
abactus	@abactus* tính từ- bị trụy thai
abacus	đỉnh cột@abacus- (tech) bàn toán số nhiều abaci abacuses- bàn tính=to move counters of an abacus; to work an abacus+ tính bằng bàn tính gảy bàn tính- (kiến trúc)- đầu cột đỉnh cột@abacus- (tech) bàn toán
abacuses	đỉnh cột@abacus- (tech) bàn toán số nhiều abaci abacuses- bàn tính=to move counters of an abacus; to work an abacus+ tính bằng bàn tính gảy bàn tính- (kiến trúc)- đầu cột đỉnh cột@abacus- (tech) bàn toán
abaddon	địa ngục- con quỷ địa ngục- con quỷ
abaft	ở phía sau=abaft the mast+ sau cột buồm gần phía bánh lái* giới từ- (hàng hải) sau ở đằng sau ở phía sau=abaft the mast+ sau cột buồm
abalienate	@abalienate* ngoại động từ- nhường lại tài sản
abalienated	@abalienate* ngoại động từ- nhường lại tài sản
abalienates	@abalienate* ngoại động từ- nhường lại tài sản
abalienating	@abalienate* ngoại động từ- nhường lại tài sản
abalienation	@abalienation* danh từ- sự nhường lại tài sản
abalone	nghĩa mỹ) bào ngưæbə''louni/* danh từ- (từ mỹnghĩa mỹ) bào ngư
abalones	nghĩa mỹ) bào ngưæbə''louni/* danh từ- (từ mỹnghĩa mỹ) bào ngư
abampere	1 abampe = 10 ampe) ampe tuyệt đối (đơn vị cường độ tuyệt đối của dòng điện 1 abampe = 10 ampe)
abandon	bỏ rơi (đ)nghĩa mỹ) từ bỏ; bỏ rơi ruồng bỏ=to abandon a hope+ từ bỏ hy vọng=to abandon one''s wife and children+ ruồng bỏ vợ con=to abandon oneself to+ đắm đuối chìm đắm vào (nỗi thất vọng...)* danh từ- sự phóng túng sự tự do sự buông thả=with abandon+ phóng túng@abandon- (tech) bỏ bỏ rơi (đ)
abandon call	@abandon call- (tech) gọi bỏ
abandoned	bỏ rơi (đ) bị ruồng bỏ- phóng đãng truỵ lạc</q></n></i></f></c><c><f><i><n><q>@abandon /ə''bændən/* ngoại động từ- bộm (nhiếp ảnh) (nhiếp ảnh) (từ mỹnghĩa mỹ) từ bỏ; bỏ rơi ruồng bỏ=to abandon a hope+ từ bỏ hy vọng=to abandon one''s wife and children+ ruồng bỏ vợ con=to abandon oneself to+ đắm đuối chìm đắm vào (nỗi thất vọng...)* danh từ- sự phóng túng sự tự do sự buông thả=with abandon+ phóng túng@abandon- (tech) bỏ bỏ rơi (đ)
abandoner	@abandoner /ə''bændənə/* danh từ- (pháp lý) người rút đơn
abandoners	@abandoner /ə''bændənə/* danh từ- (pháp lý) người rút đơn
abandoning	bỏ rơi (đ)nghĩa mỹ) từ bỏ; bỏ rơi ruồng bỏ=to abandon a hope+ từ bỏ hy vọng=to abandon one''s wife and children+ ruồng bỏ vợ con=to abandon oneself to+ đắm đuối chìm đắm vào (nỗi thất vọng...)* danh từ- sự phóng túng sự tự do sự buông thả=with abandon+ phóng túng@abandon- (tech) bỏ bỏ rơi (đ)
abandonment	từ bỏ (d) sự từ bỏ sự bỏ rơi sự ruồng bỏ- tình trạng bị bỏ rơi tình trạng bị ruồng bỏ- sự phóng túng sự tự do sự buông thả@abandonment- (tech) bỏ từ bỏ (d)
abandonments	từ bỏ (d) sự từ bỏ sự bỏ rơi sự ruồng bỏ- tình trạng bị bỏ rơi tình trạng bị ruồng bỏ- sự phóng túng sự tự do sự buông thả@abandonment- (tech) bỏ từ bỏ (d)
abandons	bỏ rơi (đ)nghĩa mỹ) từ bỏ; bỏ rơi ruồng bỏ=to abandon a hope+ từ bỏ hy vọng=to abandon one''s wife and children+ ruồng bỏ vợ con=to abandon oneself to+ đắm đuối chìm đắm vào (nỗi thất vọng...)* danh từ- sự phóng túng sự tự do sự buông thả=with abandon+ phóng túng@abandon- (tech) bỏ bỏ rơi (đ)
abapikal	@abapikal* tính từ- (sinh học) xa đỉnh; xa ngọn- dưới vực
abarticular	@abarticular* tính từ- (giải phẫu) học ngoài khớp; trật khớp
abas	@aba /''ɑ:bə/* danh từ- áo aba (áo ngoài giống hình cái túi người a-rập)
abase	làm nhục=to abase one-self+ tự hạ mình làm mất thể diện làm nhục=to abase one-self+ tự hạ mình
abased	làm nhục=to abase one-self+ tự hạ mình làm mất thể diện làm nhục=to abase one-self+ tự hạ mình
abasement	sự làm nhục sự làm mất thể diện sự làm nhục
abasements	sự làm nhục sự làm mất thể diện sự làm nhục
abases	làm nhục=to abase one-self+ tự hạ mình làm mất thể diện làm nhục=to abase one-self+ tự hạ mình
abash	làm luống cuống làm lúng túng làm luống cuống
abashed	làm luống cuống xấu hổ</q></n></i></f></c><c><f><i><n><q>@abash /ə''bæʃ/* ngoại động từ- làm bối rối làm lúng túng làm luống cuống
abashes	làm luống cuống làm lúng túng làm luống cuống
abashing	làm luống cuống làm lúng túng làm luống cuống
abashment	sự luống cuống sự lúng túng sự luống cuống
abashments	sự luống cuống sự lúng túng sự luống cuống
abasing	làm nhục=to abase one-self+ tự hạ mình làm mất thể diện làm nhục=to abase one-self+ tự hạ mình
abask	trong ánh lửa ấm dưới ánh mặt trời trong ánh lửa ấm
abatable	có thể thủ tiêu có thể làm yếu đi có thể giảm bớt- có thể hạ có thể bớt- có thể làm nhụt- có thể chấm dứt có thể thanh trừ- (pháp lý) có thể huỷ bỏ có thể thủ tiêu
abate	ngớt=paint abates+ cơn đau dịu đi=storm abates+ cơn bão ngớt làm yếu đi làm giảm bớt=to abate a pain+ làm dịu đau- hạ (giá) bớt (giá)- làm nhụt (nhụt khí...)- làm cùn (lưỡi dao...)- thanh toán làm mất hết (những điều khó chịu bực bội)- (pháp lý) huỷ bỏ thủ tiêu- (kỹ thuật) ram (thép)* nội động từ- dịu đi yếu đi nhụt đi đỡ bớt ngớt=paint abates+ cơn đau dịu đi=storm abates+ cơn bão ngớt
abated	ngớt=paint abates+ cơn đau dịu đi=storm abates+ cơn bão ngớt làm yếu đi làm giảm bớt=to abate a pain+ làm dịu đau- hạ (giá) bớt (giá)- làm nhụt (nhụt khí...)- làm cùn (lưỡi dao...)- thanh toán làm mất hết (những điều khó chịu bực bội)- (pháp lý) huỷ bỏ thủ tiêu- (kỹ thuật) ram (thép)* nội động từ- dịu đi yếu đi nhụt đi đỡ bớt ngớt=paint abates+ cơn đau dịu đi=storm abates+ cơn bão ngớt
abatement	sự thủ tiêu=abatement of a contract+ sự huỷ bỏ một hợp đồng sự yếu đi sự nhụt đi sự giảm bớt sự đỡ sự ngớt- sự hạ (giá) sự bớt (giá)- sự chấm dứt sự thanh toán- (pháp lý) sự huỷ bỏ sự thủ tiêu=abatement of a contract+ sự huỷ bỏ một hợp đồng
abatement cost	@abatement cost- (econ) chi phí kiểm soát; chi phí chống (ô nhiễm)+ chi phí làm giảm sự khó chịu như ô nhiễm hay tắc đường.
abatements	sự thủ tiêu=abatement of a contract+ sự huỷ bỏ một hợp đồng sự yếu đi sự nhụt đi sự giảm bớt sự đỡ sự ngớt- sự hạ (giá) sự bớt (giá)- sự chấm dứt sự thanh toán- (pháp lý) sự huỷ bỏ sự thủ tiêu=abatement of a contract+ sự huỷ bỏ một hợp đồng
abater	@abater* danh từ- người giảm bớt- (y học) thuốc làm dịu
abates	ngớt=paint abates+ cơn đau dịu đi=storm abates+ cơn bão ngớt làm yếu đi làm giảm bớt=to abate a pain+ làm dịu đau- hạ (giá) bớt (giá)- làm nhụt (nhụt khí...)- làm cùn (lưỡi dao...)- thanh toán làm mất hết (những điều khó chịu bực bội)- (pháp lý) huỷ bỏ thủ tiêu- (kỹ thuật) ram (thép)* nội động từ- dịu đi yếu đi nhụt đi đỡ bớt ngớt=paint abates+ cơn đau dịu đi=storm abates+ cơn bão ngớt
abating	ngớt=paint abates+ cơn đau dịu đi=storm abates+ cơn bão ngớt làm yếu đi làm giảm bớt=to abate a pain+ làm dịu đau- hạ (giá) bớt (giá)- làm nhụt (nhụt khí...)- làm cùn (lưỡi dao...)- thanh toán làm mất hết (những điều khó chịu bực bội)- (pháp lý) huỷ bỏ thủ tiêu- (kỹ thuật) ram (thép)* nội động từ- dịu đi yếu đi nhụt đi đỡ bớt ngớt=paint abates+ cơn đau dịu đi=storm abates+ cơn bão ngớt
abatis	đống cây cản số nhiều abatis- (quân sự) đống cây chướng ngại đống cây cản
abatised	có đống cây cản có đống cây cản
abatises	đống cây cản số nhiều abatis- (quân sự) đống cây chướng ngại đống cây cản
abattoir	lò sát sinh lò sát sinh
abattoirs	lò sát sinh lò sát sinh
abaxial	xa trục xa trục
abaya	@abaya* danh từ- áo aba (của người a rập)
abb	sợi khổ (của tấm vải) sợi khổ (của tấm vải)
abbacies	@abbacy /''æbəsi/* danh từ- chức vị trưởng tu viện; quyền hạn trưởng tu viện
abbacy	@abbacy /''æbəsi/* danh từ- chức vị trưởng tu viện; quyền hạn trưởng tu viện
abbatial	@abbatial /ə''beiʃəl/* tính từ- (thuộc) trưởng tu viện
abbess	@abbess /''æbis/* danh từ- bà trưởng tu viện</q></n></i></f></c><c><f><i><n><q>@abbot /''æbət/* danh từ- cha trưởng tu viện
abbesses	@abbess /''æbis/* danh từ- bà trưởng tu viện</q></n></i></f></c><c><f><i><n><q>@abbot /''æbət/* danh từ- cha trưởng tu viện
abbey	các bà xơ nhà thờ (lớn) các nhà tu các bà xơ nhà thờ (lớn)
abbeys	các bà xơ nhà thờ (lớn) các nhà tu các bà xơ nhà thờ (lớn)
abbo	abbos- người thổ dân; dân cư trú đầu tiên tại địa phương abbos- người thổ dân; dân cư trú đầu tiên tại địa phương
abbot	@abbot /''æbət/* danh từ- cha trưởng tu viện
abbots	@abbot /''æbət/* danh từ- cha trưởng tu viện
abbr	chữ viết tắt abbreviation) viết tắt chữ viết tắt
abbreviate	viết tắt viết tắt; rút ngắn lại (cuộc đi thăm...)- (toán học) ước lược rút gọn* tính từ- tương đối ngắn@abbreviate- (tech) rút gọn; viết tắt@abbreviate- viết gọn viết tắt
abbreviated	viết tắt viết tắt; rút ngắn lại (cuộc đi thăm...)- (toán học) ước lược rút gọn* tính từ- tương đối ngắn@abbreviate- (tech) rút gọn; viết tắt@abbreviate- viết gọn viết tắt
abbreviated address	@abbreviated address- (tech) địa chỉ rút gọn
abbreviates	viết tắt viết tắt; rút ngắn lại (cuộc đi thăm...)- (toán học) ước lược rút gọn* tính từ- tương đối ngắn@abbreviate- (tech) rút gọn; viết tắt@abbreviate- viết gọn viết tắt
abbreviating	viết tắt viết tắt; rút ngắn lại (cuộc đi thăm...)- (toán học) ước lược rút gọn* tính từ- tương đối ngắn@abbreviate- (tech) rút gọn; viết tắt@abbreviate- viết gọn viết tắt
abbreviation	sự viết tắtbri:vi''eiʃn/* danh từ- sự tóm tắt sự rút ngắn (cuộc đi thăm...)- bài tóm tắt- chữ viết tắt=jan is the abbreviation january+ jan là chữ viết tắt của january- (toán học) sự ước lược sự rút gọn@abbreviation- (tech) sự tóm tắt; chữ viết tắt@abbreviation- sự viết gọn sự viết tắt
abbreviations	sự viết tắtbri:vi''eiʃn/* danh từ- sự tóm tắt sự rút ngắn (cuộc đi thăm...)- bài tóm tắt- chữ viết tắt=jan is the abbreviation january+ jan là chữ viết tắt của january- (toán học) sự ước lược sự rút gọn@abbreviation- (tech) sự tóm tắt; chữ viết tắt@abbreviation- sự viết gọn sự viết tắt
abbreviator	@abbreviator /ə''bri:vieitə/* danh từ- người tóm tắt
abbreviators	@abbreviator /ə''bri:vieitə/* danh từ- người tóm tắt
abc	cơ sở- &lt;đsắt&gt; bảng chỉ đường theo abc* danh từ- (vt của american broadcasting company) công ty phát thanh truyền hình mỹ- (vt của australian broadcasting commission) uy ban phát thanh truyền hình uc đại lợi cơ sở- &lt;đsắt&gt; bảng chỉ đường theo abc* danh từ- (vt của american broadcasting company) công ty phát thanh truyền hình mỹ- (vt của australian broadcasting commission) uy ban phát thanh truyền hình uc đại lợi
abc-book	sách học vần sách học vần
abcauline	xa thân xa thân
abdicable	@abdicable- xem abdicate
abdicant	@abdicant /''æbdikeitə/ (abdicant) /''æbdikənt/* danh từ- người từ bỏ- người thoái vị
abdicants	@abdicant /''æbdikeitə/ (abdicant) /''æbdikənt/* danh từ- người từ bỏ- người thoái vị
abdicate	từ ngôi địa vị...)=to abdicate a position+ từ bỏ một địa vị=to abdicate all one''s rights+ từ bỏ mọi quyền lợi* nội động từ- thoái vị từ ngôi
abdicated	từ ngôi địa vị...)=to abdicate a position+ từ bỏ một địa vị=to abdicate all one''s rights+ từ bỏ mọi quyền lợi* nội động từ- thoái vị từ ngôi
abdicates	từ ngôi địa vị...)=to abdicate a position+ từ bỏ một địa vị=to abdicate all one''s rights+ từ bỏ mọi quyền lợi* nội động từ- thoái vị từ ngôi
abdicating	từ ngôi địa vị...)=to abdicate a position+ từ bỏ một địa vị=to abdicate all one''s rights+ từ bỏ mọi quyền lợi* nội động từ- thoái vị từ ngôi
abdication	quyền lợi...)æbdi''keiʃn/* danh từ- sự thoái vị sự từ ngôi- sự từ bỏ (địa vị chức vụ quyền lợi...)
abdications	quyền lợi...)æbdi''keiʃn/* danh từ- sự thoái vị sự từ ngôi- sự từ bỏ (địa vị chức vụ quyền lợi...)
abdicator	@abdicator /''æbdikeitə/ (abdicant) /''æbdikənt/* danh từ- người từ bỏ- người thoái vị
abdicators	@abdicator /''æbdikeitə/ (abdicant) /''æbdikənt/* danh từ- người từ bỏ- người thoái vị
abdomen	@abdomen /''æbdəmen/* danh từ- bụng
abdomens	@abdomen /''æbdəmen/* danh từ- bụng
abdominal	@abdominal /æb''dɔminl/* tính từ- (thuộc) bụng; ở bụng=an abdominal operation+ phẫu thuật ở bụng=abdominal cavity+ khoang bụng
abdominally	@abdominally* phó từ- (thuộc) bụng; ở bụng
abdominous	@abdominous /æb''dɔminəs/* tính từ- phệ bụng
abducens	@abducens* danh từ- dây thần kinh não vi ra ngoài
abducent	giạng ra giạng ra
abducentes	@abducens* danh từ- dây thần kinh não vi ra ngoài
abduct	giạng ra cuỗm đi lừa đem đi (người đàn bà...)- (giải phẫu) rẽ ra giạng ra
abducted	giạng ra cuỗm đi lừa đem đi (người đàn bà...)- (giải phẫu) rẽ ra giạng ra
abducting	giạng ra cuỗm đi lừa đem đi (người đàn bà...)- (giải phẫu) rẽ ra giạng ra
abduction	sự lừa đem đi- (giải phẫu) sự giạng ra sự bắt đi sự cuỗm đi sự lừa đem đi- (giải phẫu) sự giạng ra
abductions	sự lừa đem đi- (giải phẫu) sự giạng ra sự bắt đi sự cuỗm đi sự lừa đem đi- (giải phẫu) sự giạng ra
abductor	người lừa đem đi- (giải phẫu) cơ giạng ((cũng) abductor muscle) người cuỗm đi người lừa đem đi- (giải phẫu) cơ giạng ((cũng) abductor muscle)
abductors	người lừa đem đi- (giải phẫu) cơ giạng ((cũng) abductor muscle) người cuỗm đi người lừa đem đi- (giải phẫu) cơ giạng ((cũng) abductor muscle)
abducts	giạng ra cuỗm đi lừa đem đi (người đàn bà...)- (giải phẫu) rẽ ra giạng ra
abeam	(hàng không) đâm ngang sườn=abeam of us+ ngang sườn chúng tôi; sóng ngang với chúng tôi (hàng không) đâm ngang sườn=abeam of us+ ngang sườn chúng tôi; sóng ngang với chúng tôi
abearance	@abearance* danh từ- phẩm hạnh= good abearance+phẩm hạnh tốt
abecedarian	nghĩa mỹ) học sinh vỡ lòngeibi:si:''deəriən/* tính từ- sắp xếp theo thứ tự abc- sơ đẳng- dốt nát* danh từ- (từ mỹnghĩa mỹ) học sinh vỡ lòng
abecedarians	nghĩa mỹ) học sinh vỡ lòngeibi:si:''deəriən/* tính từ- sắp xếp theo thứ tự abc- sơ đẳng- dốt nát* danh từ- (từ mỹnghĩa mỹ) học sinh vỡ lòng
abecedaries	@abecedaries* danh từ- sách vỡ lòng; sách vần- điều sơ bộ; điều sơ đẳng
abed	@abed /ə''bed/* phó từ- ở trên giường=to lie abed+ nằm ở trên giường
abele	@abele /ə''bi:l/* danh từ- (thực vật học) cây bạch dương
abelmosk	@abelmosk /''eibəlmɔsk/* danh từ- (thực vật học) cây vông vàng
abend (abnormal ending)	@abend (abnormal ending)- (tech) kết thúc/chấm dứt bất thường
abenteric	xa ruột xa ruột
aberrance	@aberrance /æ''berəns/ (aberrancy) /æ''berənsi/* danh từ- sự lầm lạc- (sinh vật học) sự khác thường
aberrances	@aberrance /æ''berəns/ (aberrancy) /æ''berənsi/* danh từ- sự lầm lạc- (sinh vật học) sự khác thường
aberrancies	@aberrancy /æ''berəns/ (aberrancy) /æ''berənsi/* danh từ- sự lầm lạc- (sinh vật học) sự khác thường
aberrancy	@aberrancy /æ''berəns/ (aberrancy) /æ''berənsi/* danh từ- sự lầm lạc- (sinh vật học) sự khác thường
aberrant	@aberrant /æ''berənt/* tính từ- lầm lạc- (sinh vật học) khác thường
aberrantly	@aberrantly- xem aberrant
aberration	sự loạn trí- sự khác thường- (vật lý) quang sai=lateral aberration+ quang sai ngang- (thiên văn học) tính sai=secular aberration+ tính sai trường kỳ=annual aberration+ tính sai hằng năm@aberration- (tech) quang sai@aberration- (vật lí) quang sai sự loạn trí- sự khác thường- (vật lý) quang sai=lateral aberration+ quang sai ngang- (thiên văn học) tính sai=secular aberration+ tính sai trường kỳ=annual aberration+ tính sai hằng năm@aberration- (tech) quang sai@aberration- (vật lí) quang sai
aberrations	sự loạn trí- sự khác thường- (vật lý) quang sai=lateral aberration+ quang sai ngang- (thiên văn học) tính sai=secular aberration+ tính sai trường kỳ=annual aberration+ tính sai hằng năm@aberration- (tech) quang sai@aberration- (vật lí) quang sai sự loạn trí- sự khác thường- (vật lý) quang sai=lateral aberration+ quang sai ngang- (thiên văn học) tính sai=secular aberration+ tính sai trường kỳ=annual aberration+ tính sai hằng năm@aberration- (tech) quang sai@aberration- (vật lí) quang sai
abet	khích- tiếp tay (ai làm bậy) xúi giục khích- tiếp tay (ai làm bậy)
abetment	sự khích- sự tiếp tay sự xúi giục sự khích- sự tiếp tay
abets	khích- tiếp tay (ai làm bậy) xúi giục khích- tiếp tay (ai làm bậy)
abettal	sự khích- sự tiếp tay sự xúi giục sự khích- sự tiếp tay
abette	@abette /ə''betə/ (abettor) /ə''betə/* danh từ- kẻ xúi giục- kẻ tiếp tay
abetted	khích- tiếp tay (ai làm bậy) xúi giục khích- tiếp tay (ai làm bậy)
abetter	@abetter* danh từ- kẻ xúi giục- kẻ tiếp tay
abetters	@abetter* danh từ- kẻ xúi giục- kẻ tiếp tay
abetting	khích- tiếp tay (ai làm bậy) xúi giục khích- tiếp tay (ai làm bậy)
abettor	@abettor /ə''betə/ (abettor) /ə''betə/* danh từ- kẻ xúi giục- kẻ tiếp tay
abettors	@abettor /ə''betə/ (abettor) /ə''betə/* danh từ- kẻ xúi giục- kẻ tiếp tay
abeyance	tình trạng khuyết (một chức vị) sự hoãn lại sự tạm thời không áp dụng (đạo luật...)=to be in abeyance; to fall into abeyance+ bị đình chỉ bị hoãn lại tạm thời không được áp dụng- (pháp lý) tình trạng tạm thời không có người nhận; tình trạng tạm thời vô chủ=lands in abeyance+ đất vô thừa nhận đất vô chủ- tình trạng trống tình trạng khuyết (một chức vị)
abeyances	tình trạng khuyết (một chức vị) sự hoãn lại sự tạm thời không áp dụng (đạo luật...)=to be in abeyance; to fall into abeyance+ bị đình chỉ bị hoãn lại tạm thời không được áp dụng- (pháp lý) tình trạng tạm thời không có người nhận; tình trạng tạm thời vô chủ=lands in abeyance+ đất vô thừa nhận đất vô chủ- tình trạng trống tình trạng khuyết (một chức vị)
abeyant	tạm nghỉ hoạt động tạm nghỉ hoạt động
abhor	@abhor /əb''hɔ:/* ngoại động từ- ghê tởm; ghét cay ghét đắng
abhorred	@abhor /əb''hɔ:/* ngoại động từ- ghê tởm; ghét cay ghét đắng
abhorrence	@abhorrence /əb''hɔrəns/* danh từ- sự ghê tởm=to have an abhorrence of+ sự ghét cay ghét đắng=to hold in abhorrence of+ ghê tởm; ghét cay ghét đắng- điều ghê tởm; cái bị ghét cay ghét đắng
abhorrences	@abhorrence /əb''hɔrəns/* danh từ- sự ghê tởm=to have an abhorrence of+ sự ghét cay ghét đắng=to hold in abhorrence of+ ghê tởm; ghét cay ghét đắng- điều ghê tởm; cái bị ghét cay ghét đắng
abhorrent	ghét cay ghét đắng cái gì đáng ghét=to be abhorrent to someone+ ghê tởm đối với ai bị ai ghê tởm bị ai ghét cay ghét đắng- (+ from) trái với mâu thuẫn với không hợp với=conduct abhorrent from principles+ tư cách mâu thuẫn với phép tắc- (từ cổnghĩa cổ) (+ of) ghê tởm ghét cay ghét đắng=to be abhorrent of something+ ghê tởm cái gì ghét cay ghét đắng cái gì
abhorrently	@abhorrently- xem abhorrent
abhorrer	@abhorrer- xem abhor
abhorrers	@abhorrer- xem abhor
abhorring	@abhor /əb''hɔ:/* ngoại động từ- ghê tởm; ghét cay ghét đắng
abhors	@abhor /əb''hɔ:/* ngoại động từ- ghê tởm; ghét cay ghét đắng
abidance	sự tuân theo luật lệ- (+ in) sự tồn tại; sự kéo dài sự tuân theo sự thi hành đúng=abidance by rules+ sự tôn trọng luật lệ sự tuân theo luật lệ- (+ in) sự tồn tại; sự kéo dài
abide	chịu=we can''t abide his fits of temper+ chúng tôi không thể chịu được những cơn nóng giận của hắn- chống đỡ được (cuộc tấn công) abide)- tồn tại; kéo dài=this mistake will not abide for ever+ sai lầm này sẽ không thể kéo dài mãi được- (+ by) tôn trọng giữ tuân theo chịu theo; trung thành với=to abide by one''s friend+ trung thành với bạn- (từ cổnghĩa cổ) ở ngụ tại=to abide with somebody+ ở với ai* ngoại động từ- chờ chờ đợi=to abide one''s time+ chờ thời cơ- chịu đựng chịu=we can''t abide his fits of temper+ chúng tôi không thể chịu được những cơn nóng giận của hắn- chống đỡ được (cuộc tấn công)
abided	chịu=we can''t abide his fits of temper+ chúng tôi không thể chịu được những cơn nóng giận của hắn- chống đỡ được (cuộc tấn công) abide)- tồn tại; kéo dài=this mistake will not abide for ever+ sai lầm này sẽ không thể kéo dài mãi được- (+ by) tôn trọng giữ tuân theo chịu theo; trung thành với=to abide by one''s friend+ trung thành với bạn- (từ cổnghĩa cổ) ở ngụ tại=to abide with somebody+ ở với ai* ngoại động từ- chờ chờ đợi=to abide one''s time+ chờ thời cơ- chịu đựng chịu=we can''t abide his fits of temper+ chúng tôi không thể chịu được những cơn nóng giận của hắn- chống đỡ được (cuộc tấn công)
abider	abider `word` `word`abides chịu=we can''t abide his fits of temper+ chúng tôi không thể chịu được những cơn nóng giận của hắn- chống đỡ được (cuộc tấn công) abide)- tồn tại; kéo dài=this mistake will not abide for ever+ sai lầm này sẽ không thể kéo dài mãi được- (+ by) tôn trọng giữ tuân theo chịu theo; trung thành với=to abide by one''s friend+ trung thành với bạn- (từ cổnghĩa cổ) ở ngụ tại=to abide with somebody+ ở với ai* ngoại động từ- chờ chờ đợi=to abide one''s time+ chờ thời cơ- chịu đựng chịu=we can''t abide his fits of temper+ chúng tôi không thể chịu được những cơn nóng giận của hắn- chống đỡ được (cuộc tấn công)
abiding	chịu=we can''t abide his fits of temper+ chúng tôi không thể chịu được những cơn nóng giận của hắn- chống đỡ được (cuộc tấn công) vĩnh cửu tồn tại mãi mãi</q></n></i></f></c><c><f><i><n><q>@abide /ə''baid/* nội động từ (abode; abode abide)- tồn tại; kéo dài=this mistake will not abide for ever+ sai lầm này sẽ không thể kéo dài mãi được- (+ by) tôn trọng giữ tuân theo chịu theo; trung thành với=to abide by one''s friend+ trung thành với bạn- (từ cổnghĩa cổ) ở ngụ tại=to abide with somebody+ ở với ai* ngoại động từ- chờ chờ đợi=to abide one''s time+ chờ thời cơ- chịu đựng chịu=we can''t abide his fits of temper+ chúng tôi không thể chịu được những cơn nóng giận của hắn- chống đỡ được (cuộc tấn công)
abidingly	@abidingly- xem abiding
abience	@abience* danh từ- sự tránh kích thích
abient	@abient* tính từ- tránh kích thích
abies	@abies* danh từ- (thực vật) cây linh sam
abietene	@abietene /''æbiəti:n/* danh từ- (hoá học) abietin
abigail	nữ tỳ nữ tỳ
abigails	nữ tỳ nữ tỳ
abilitate	nghĩa hiếm) (như) habiliatenghĩa hiếm) (như) habiliate
abilities	nguồn vốn (để đáp ứng khi cần thiết)=to be best of one''s ability+ với tư cách khả năng của mình@ability- khả năng khả năng (làm việc gì)- (số nhiều) tài năng tài cán=a man of abilities+ một người tài năng* (pháp lý)- thẩm quyền- (thương nghiệp) khả năng thanh toán được; vốn sẵn có nguồn vốn (để đáp ứng khi cần thiết)=to be best of one''s ability+ với tư cách khả năng của mình@ability- khả năng
ability	nguồn vốn (để đáp ứng khi cần thiết)=to be best of one''s ability+ với tư cách khả năng của mình@ability- khả năng khả năng (làm việc gì)- (số nhiều) tài năng tài cán=a man of abilities+ một người tài năng* (pháp lý)- thẩm quyền- (thương nghiệp) khả năng thanh toán được; vốn sẵn có nguồn vốn (để đáp ứng khi cần thiết)=to be best of one''s ability+ với tư cách khả năng của mình@ability- khả năng
ability and earnings	làm tăng khả năng là phần lớn lợi tức được ước tính do giáo dục trên thực tế cũng chính là lợi tức do năng lực làm tăng khả năng là phần lớn lợi tức được ước tính do giáo dục trên thực tế cũng chính là lợi tức do năng lực
ability to pay	@ability to pay- (econ) khả năng chi trả.
ability to pay theory	tuỳ thuộc vào thước đo được sử dụng và độ dốc giả định của đồ thị thoả dụng biên của thu nhập. tỷ lệ hay luỹ thoái tuỳ thuộc vào thước đo được sử dụng và độ dốc giả định của đồ thị thoả dụng biên của thu nhập.
abiogeneses	eibai''ɔdʤini/* danh từ- (sinh vật học) sự phát sinh tự nhiêneibaiou''dʤenisis/ (abiogeny) /eibai''ɔdʤini/* danh từ- (sinh vật học) sự phát sinh tự nhiên
abiogenesis	eibai''ɔdʤini/* danh từ- (sinh vật học) sự phát sinh tự nhiêneibaiou''dʤenisis/ (abiogeny) /eibai''ɔdʤini/* danh từ- (sinh vật học) sự phát sinh tự nhiên
abiogenetic	eibaioudʤi''netik/* tính từ- (sinh vật học) phát sinh tự nhiêneibaioudʤi''netik/* tính từ- (sinh vật học) phát sinh tự nhiên
abiogenetically	eibaioudʤi''netikəli/* phó từ- (sinh vật học) phát sinh tự nhiêneibaioudʤi''netikəli/* phó từ- (sinh vật học) phát sinh tự nhiên
abiogenist	eibai''ɔdʤinist/* danh từ- người tin thuyết phát sinh tự nhiêneibai''ɔdʤinist/* danh từ- người tin thuyết phát sinh tự nhiên
abiogenous	eibai''ɔdʤiəns/* tính từ- (sinh vật học) phát sinh tự nhiêneibai''ɔdʤiəns/* tính từ- (sinh vật học) phát sinh tự nhiên
abiogeny	eibai''ɔdʤini/* danh từ- (sinh vật học) sự phát sinh tự nhiêneibaiou''dʤenisis/ (abiogeny) /eibai''ɔdʤini/* danh từ- (sinh vật học) sự phát sinh tự nhiên
abiological	æbaiə''lɔdʤikəl/* tính từ- phi sinh vật họcæbaiə''lɔdʤikəl/* tính từ- phi sinh vật học
abiologically	@abiologically- xem abiological
abioses	@abiosis- xem abiotic
abioseston	@abioseston* danh từ- (sinh học) chất vô cơ lơ lửng
abiosis	@abiosis- xem abiotic
abiotic	æbai''ɔtik/* tính từ- vô sinhæbai''ɔtik/* tính từ- vô sinh
abiotically	@abiotically- xem abiotic
abiotrophic	@abiotrophic* tính từ- kiệt sức sống; suy sức sống
abirritant	@abirritant* danh từ- thuốc giảm kích thích
abirritate	@abirritate* ngoại động từ- giảm kích thích
abirritation	@abirritation* danh từ- sự giảm kích thích
abject	nghèo xác nghèo xơ thấp hèn đê tiện đáng khinh- khốn khổ khốn nạn=in abject poverty+ nghèo rớt mồng tơi nghèo xác nghèo xơ
abjection	sự đê tiện sự thấp hèn sự đê tiện
abjections	sự đê tiện sự thấp hèn sự đê tiện
abjectly	khốn nạn đê tiện- khốn khổ khốn nạn
abjectness	sự khốn nạn sự thấp hèn sự đê tiện sự đáng khinh- sự khốn khổ sự khốn nạn
abjudicate	@abjudicate* ngoại động từ- tuyên bố từ bỏ- thề bỏ đạo
abjuration	sự bội đạoæbdʤuə''reiʃn/* danh từ- sự tuyên bố bỏ sự thề bỏ- (tôn giáo) sự thề bỏ đạo sự bội đạo
abjurations	sự bội đạoæbdʤuə''reiʃn/* danh từ- sự tuyên bố bỏ sự thề bỏ- (tôn giáo) sự thề bỏ đạo sự bội đạo
abjure	lời hứa...)=to abjure one''s opinion+ rút lui ý kiến- thề bỏ (đất nước) đi mãi mãi nguyện bỏ=to abjure one''s religion+ bỏ đạo=to abjure one''s rights+ tuyên bố từ bỏ quyền lợi của mình- rút lui (ý kiến lời hứa...)=to abjure one''s opinion+ rút lui ý kiến- thề bỏ (đất nước) đi mãi mãi
abjured	lời hứa...)=to abjure one''s opinion+ rút lui ý kiến- thề bỏ (đất nước) đi mãi mãi nguyện bỏ=to abjure one''s religion+ bỏ đạo=to abjure one''s rights+ tuyên bố từ bỏ quyền lợi của mình- rút lui (ý kiến lời hứa...)=to abjure one''s opinion+ rút lui ý kiến- thề bỏ (đất nước) đi mãi mãi
abjurer	@abjurer- xem abjure
abjures	lời hứa...)=to abjure one''s opinion+ rút lui ý kiến- thề bỏ (đất nước) đi mãi mãi nguyện bỏ=to abjure one''s religion+ bỏ đạo=to abjure one''s rights+ tuyên bố từ bỏ quyền lợi của mình- rút lui (ý kiến lời hứa...)=to abjure one''s opinion+ rút lui ý kiến- thề bỏ (đất nước) đi mãi mãi
abjuring	lời hứa...)=to abjure one''s opinion+ rút lui ý kiến- thề bỏ (đất nước) đi mãi mãi nguyện bỏ=to abjure one''s religion+ bỏ đạo=to abjure one''s rights+ tuyên bố từ bỏ quyền lợi của mình- rút lui (ý kiến lời hứa...)=to abjure one''s opinion+ rút lui ý kiến- thề bỏ (đất nước) đi mãi mãi
ablactation	æblæk''teiʃn/* danh từ- sự cai sữa- sự cạn sữaæblæk''teiʃn/* danh từ- sự cai sữa- sự cạn sữa
ablastous	@ablastous* tính từ- (thực vật) không mầm
ablate	@ablate /æb''leit/* ngoại động từ- (y học) cắt bỏ
ablated	@ablate /æb''leit/* ngoại động từ- (y học) cắt bỏ
ablates	@ablate /æb''leit/* ngoại động từ- (y học) cắt bỏ
ablating	@ablate /æb''leit/* ngoại động từ- (y học) cắt bỏ
ablation	địa chất) sự tiêu mòn (sông băng)địa chất) sự tải mòn (đá)- (địa lýđịa chất) sự tiêu mòn (sông băng)
ablations	địa chất) sự tiêu mòn (sông băng)địa chất) sự tải mòn (đá)- (địa lýđịa chất) sự tiêu mòn (sông băng)
ablative	@ablative /''æblətiv/* tính từ- (ngôn ngữ học) (thuộc) cách công cụ* danh từ- (ngôn ngữ học) cách công cụ
ablatives	@ablative /''æblətiv/* tính từ- (ngôn ngữ học) (thuộc) cách công cụ* danh từ- (ngôn ngữ học) cách công cụ
ablaut	@ablaut /''æblaut/* danh từ- (ngôn ngữ học) aplau
ablaze	rừng rực=ablaze with anger+ bừng bừng nổi giận bốc cháy- sáng chói lọi- bừng bừng rừng rực=ablaze with anger+ bừng bừng nổi giận
able	có đủ thẩm quyền có tài=an able co-op manager+ một chủ nhiệm hợp tác xã có năng lực=an able writer+ một nhà văn có tài=to be able to+ có thể=to be able to do something+ có thể làm được việc gì- (pháp lý) có đủ tư cách có đủ thẩm quyền
able seaman	@able seaman* danh từ- (vt là ab) thủy thủ hạng nhất
able-bodied	@able-bodied /''eibl''bɔdid/* tính từ- khoẻ mạnh; đủ tiêu chuẩn sức khoẻ (làm nghĩa vụ quân sự)=able-bodied seaman+ ((viết tắt) a.b.) thuỷ thủ hạng nhất
ablegate	@ablegate* danh từ- đại sứ giáo hoàng
ablen	cá vảy bạc (họ cá chép) cá vảy bạc (họ cá chép)
ableness	tài năng- sự cường tráng tài năng- sự cường tráng
ablepsia	@ablepsia* danh từ- tật mù; chứng mù
abler	có đủ thẩm quyền có tài=an able co-op manager+ một chủ nhiệm hợp tác xã có năng lực=an able writer+ một nhà văn có tài=to be able to+ có thể=to be able to do something+ có thể làm được việc gì- (pháp lý) có đủ tư cách có đủ thẩm quyền
ablest	có đủ thẩm quyền có tài=an able co-op manager+ một chủ nhiệm hợp tác xã có năng lực=an able writer+ một nhà văn có tài=to be able to+ có thể=to be able to do something+ có thể làm được việc gì- (pháp lý) có đủ tư cách có đủ thẩm quyền
ablet	cá vảy bạc (họ cá chép) cá vảy bạc (họ cá chép)
ablings	có thể có thể
ablins	có thể có thể
abloom	@abloom /ə''blu:m/* tính từ &amp; phó từ- đang nở (ra) hoa
abluent	thuốc tẩy tẩy sạch* danh từ- chất tẩy thuốc tẩy
ablush	@ablush /ə''blʌʃ/* tính từ &amp; phó từ- thẹn đỏ mặt
ablution	sự rửa ráy (thường) số nhiều- (tôn giáo) lễ rửa tội; lễ tắm gội; lễ rửa sạch các đồ thờ- (tôn giáo) nước tắm gội; nước rửa đồ thờ- ((thường) số nhiều) sự tắm gội sự rửa ráy
ablutionary	@ablutionary- xem ablution
ablutions	sự rửa ráy (thường) số nhiều- (tôn giáo) lễ rửa tội; lễ tắm gội; lễ rửa sạch các đồ thờ- (tôn giáo) nước tắm gội; nước rửa đồ thờ- ((thường) số nhiều) sự tắm gội sự rửa ráy
ably	tài tình có tài khéo léo tài tình
abm	@abm- (vt của anti-ballistic missile) tên lửa chống tên lửa đạn đạo
abnegate	@abnegate /''æbnigeit/* ngoại động từ- nhịn (cái gì)- bỏ (đạo)- từ bỏ (quyền lợi...); từ chối không nhận (đặc quyền...)
abnegated	@abnegate /''æbnigeit/* ngoại động từ- nhịn (cái gì)- bỏ (đạo)- từ bỏ (quyền lợi...); từ chối không nhận (đặc quyền...)
abnegates	@abnegate /''æbnigeit/* ngoại động từ- nhịn (cái gì)- bỏ (đạo)- từ bỏ (quyền lợi...); từ chối không nhận (đặc quyền...)
abnegating	@abnegate /''æbnigeit/* ngoại động từ- nhịn (cái gì)- bỏ (đạo)- từ bỏ (quyền lợi...); từ chối không nhận (đặc quyền...)
abnegation	sự xả thân ((thường) self abnegation)æbni''geiʃn/* danh từ- sự bỏ (đạo...); sự từ bỏ (quyền lợi); sự từ chối không nhận (đặc quyền...)- sự quên mình sự hy sinh sự xả thân ((thường) self abnegation)
abnegations	sự xả thân ((thường) self abnegation)æbni''geiʃn/* danh từ- sự bỏ (đạo...); sự từ bỏ (quyền lợi); sự từ chối không nhận (đặc quyền...)- sự quên mình sự hy sinh sự xả thân ((thường) self abnegation)
abnegator	@abnegator- xem abnegate
abnegators	@abnegator- xem abnegate
abnormal	dị thường; không chuẩn@abnormal- bất thường; (thống kê) không chuẩn khác thường; dị thường@abnormal- (tech) bất thường dị thường; không chuẩn@abnormal- bất thường; (thống kê) không chuẩn
abnormal end (abend)	@abnormal end (abend)- (tech) kết thúc bất thường
abnormal end of task	@abnormal end of task- (tech) kết thúc bất thường (một) nhiệm vụ
abnormal end of transmission	@abnormal end of transmission- (tech) kết thúc truyền bất thường
abnormal function	@abnormal function- (tech) chức năng/hàm số bất thường
abnormal profits	@abnormal profits- (econ) lợi nhuận dị thường+ xem super-normal profits
abnormal propagation	@abnormal propagation- (tech) truyền lan bất thường
abnormal reflection	@abnormal reflection- (tech) phản xạ bất thường
abnormal refraction	@abnormal refraction- (tech) khúc xạ bất thường
abnormal return address	@abnormal return address- (tech) địa chỉ hồi báo bất thường
abnormal status	@abnormal status- (tech) trạng thái bất thường
abnormal termination	@abnormal termination- (tech) cắt dứt bất thường
abnormalcy	quái vật sự khác thường; sự dị thường- vật kỳ quái quái vật
abnormalities	quái vật sự khác thường; sự dị thường- vật kỳ quái quái vật
abnormality	quái vật sự khác thường; sự dị thường- vật kỳ quái quái vật
abnormally	khác thường khác thường
abnormities	quái vật sự khác thường; sự dị thường- vật kỳ quái quái vật
abnormity	quái vật sự khác thường; sự dị thường- vật kỳ quái quái vật
abo	sỉ nhục) lóng sỉ nhục)
aboard	máy bay...)=to go aboard a ship+ lên tàu=to travel aboard a special train+ đi du lịch trên một chuyến xe lửa đặc biệt trên boong tàu trên thuyền trên xe lửa; trên máy bay=to go aboard+ lên tàu lên boong- dọc theo; gần kế=close (hard) aboard+ nằm kế sát=to keep the land aboard+ đi dọc theo bờ=all aboard!+ đề nghị mọi người lên tàu!=to fall aboard of a ship+ va phải một chiếc tàu khác* giới từ- lên trên (tàu thuỷ xe lửa máy bay...)=to go aboard a ship+ lên tàu=to travel aboard a special train+ đi du lịch trên một chuyến xe lửa đặc biệt
abode	chịu=we can''t abide his fits of temper+ chúng tôi không thể chịu được những cơn nóng giận của hắn- chống đỡ được (cuộc tấn công) sự lưu lại* thời quá khứ &amp; động tính từ quá khứ của abide</q></n></i></f></c><c><f><i><n><q>@abide /ə''baid/* nội động từ (abode; abode abide)- tồn tại; kéo dài=this mistake will not abide for ever+ sai lầm này sẽ không thể kéo dài mãi được- (+ by) tôn trọng giữ tuân theo chịu theo; trung thành với=to abide by one''s friend+ trung thành với bạn- (từ cổnghĩa cổ) ở ngụ tại=to abide with somebody+ ở với ai* ngoại động từ- chờ chờ đợi=to abide one''s time+ chờ thời cơ- chịu đựng chịu=we can''t abide his fits of temper+ chúng tôi không thể chịu được những cơn nóng giận của hắn- chống đỡ được (cuộc tấn công)
abodes	sự lưu lại* thời quá khứ &amp; động tính từ quá khứ của abide sự lưu lại* thời quá khứ &amp; động tính từ quá khứ của abide
abohm	@abohm- (tech) abôm (1 abôm = 10 lũy thừa -9 ôm)
aboil	@aboil /ə''bɔil/* tính từ &amp; phó từ- đang sôi
abolish	huỷ bỏ=to abolish the exploitation of man by man+ thủ tiêu chế độ người bóc lột người=to abolish acontract+ huỷ bỏ một bản giao kèo bãi bỏ huỷ bỏ=to abolish the exploitation of man by man+ thủ tiêu chế độ người bóc lột người=to abolish acontract+ huỷ bỏ một bản giao kèo
abolishable	có thể huỷ bỏ có thể bãi bỏ có thể huỷ bỏ
abolished	huỷ bỏ=to abolish the exploitation of man by man+ thủ tiêu chế độ người bóc lột người=to abolish acontract+ huỷ bỏ một bản giao kèo bãi bỏ huỷ bỏ=to abolish the exploitation of man by man+ thủ tiêu chế độ người bóc lột người=to abolish acontract+ huỷ bỏ một bản giao kèo
abolisher	người huỷ bỏ người bãi bỏ người huỷ bỏ
abolishers	người huỷ bỏ người bãi bỏ người huỷ bỏ
abolishes	huỷ bỏ=to abolish the exploitation of man by man+ thủ tiêu chế độ người bóc lột người=to abolish acontract+ huỷ bỏ một bản giao kèo bãi bỏ huỷ bỏ=to abolish the exploitation of man by man+ thủ tiêu chế độ người bóc lột người=to abolish acontract+ huỷ bỏ một bản giao kèo
abolishing	huỷ bỏ=to abolish the exploitation of man by man+ thủ tiêu chế độ người bóc lột người=to abolish acontract+ huỷ bỏ một bản giao kèo bãi bỏ huỷ bỏ=to abolish the exploitation of man by man+ thủ tiêu chế độ người bóc lột người=to abolish acontract+ huỷ bỏ một bản giao kèo
abolishment	sự huỷ bỏ sự bãi bỏ sự huỷ bỏ
abolition	sự huỷ bỏ=abolition of taxes+ sự bãi bỏ thuế=abolition of slavery+ sự thủ tiêu chế độ nô lệæbə''liʃn/* danh từ- sự thủ tiêu sự bãi bỏ sự huỷ bỏ=abolition of taxes+ sự bãi bỏ thuế=abolition of slavery+ sự thủ tiêu chế độ nô lệ
abolitionary	@abolitionary- xem abolition
abolitionise	nghĩa mỹ) làm cho theo chủ nghĩa bãi nôæbə''liʃənaiz/ (abolitionise) /æbə''liʃənaiz/* ngoại động từ- (từ mỹnghĩa mỹ) làm cho theo chủ nghĩa bãi nô
abolitionism	æbə''liʃənizm/* danh từ- (sử học) chủ nghĩa bãi nôæbə''liʃənizm/* danh từ- (sử học) chủ nghĩa bãi nô
abolitionist	æbə''liʃənist/* danh từ- người theo chủ nghĩa bãi nôæbə''liʃənist/* danh từ- người theo chủ nghĩa bãi nô
abolitionists	æbə''liʃənist/* danh từ- người theo chủ nghĩa bãi nôæbə''liʃənist/* danh từ- người theo chủ nghĩa bãi nô
abolitionize	nghĩa mỹ) làm cho theo chủ nghĩa bãi nôæbə''liʃənaiz/ (abolitionise) /æbə''liʃənaiz/* ngoại động từ- (từ mỹnghĩa mỹ) làm cho theo chủ nghĩa bãi nô
abolitions	sự huỷ bỏ=abolition of taxes+ sự bãi bỏ thuế=abolition of slavery+ sự thủ tiêu chế độ nô lệæbə''liʃn/* danh từ- sự thủ tiêu sự bãi bỏ sự huỷ bỏ=abolition of taxes+ sự bãi bỏ thuế=abolition of slavery+ sự thủ tiêu chế độ nô lệ
abomasa	@abomasum* danh từ- dạ múi khế túi (động vật nhai lại)
abomasum	@abomasum* danh từ- dạ múi khế túi (động vật nhai lại)
abominable	rất xấu=abominable weather+ thời tiết rất xấu=an abominable meal+ bữa cơm tồi kinh tởm=an abominable crime tội ác ghê tởm+ (thông tục) tồi tồi tệ rất xấu=abominable weather+ thời tiết rất xấu=an abominable meal+ bữa cơm tồi
abominable snowman	@abominable snowman* danh từ- người tuyết (tương truyền là động vật to cao)
abominableness	sự kinh tởm- (thông tục) sự tồi tệ sự kinh tởm- (thông tục) sự tồi tệ
abominably	@abominably* phó từ- một cách đáng ghê tởm
abominate	kinh tởm ghét mặt* tính từ- (thơ ca) ghê tởm kinh tởm
abominated	kinh tởm ghét mặt* tính từ- (thơ ca) ghê tởm kinh tởm
abominates	kinh tởm ghét mặt* tính từ- (thơ ca) ghê tởm kinh tởm
abominating	kinh tởm ghét mặt* tính từ- (thơ ca) ghê tởm kinh tởm
abomination	sự kinh tởm; sự ghét cay ghét đắng=to hold something in abomination+ ghê tởm cái gì- vật kinh tởm; việc ghê tởm; hành động đáng ghétbɔmi''neiʃn/* danh từ- sự ghê tởm sự kinh tởm; sự ghét cay ghét đắng=to hold something in abomination+ ghê tởm cái gì- vật kinh tởm; việc ghê tởm; hành động đáng ghét
abominations	sự kinh tởm; sự ghét cay ghét đắng=to hold something in abomination+ ghê tởm cái gì- vật kinh tởm; việc ghê tởm; hành động đáng ghétbɔmi''neiʃn/* danh từ- sự ghê tởm sự kinh tởm; sự ghét cay ghét đắng=to hold something in abomination+ ghê tởm cái gì- vật kinh tởm; việc ghê tởm; hành động đáng ghét
abominator	@abominator- xem abominate
abominators	@abominator- xem abominate
abonent	@abonent- (tech) người thuê bao; người dùng đầu cuối
aboral	@aboral* tính từ- (sinh học) xa miệng; đối miệng
aboriginal	nghĩa hiếm) thổ sảnæbə''ridʤənl/* tính từ- (thuộc) thổ dân; (thuộc) thổ sản (thuộc) đặc sản=the aboriginal inhabitants of a country+ thổ dân của một nước=tea is an aboriginal product of phutho+ chè là một đặc sản của phú thọ- ban sơ nguyên thuỷ cổ sơ* danh từ- thổ dân- (từ hiếmnghĩa hiếm) thổ sản
aboriginality	@aboriginality* danh từ- đặc điểm nguyên sơ- tính thuần phát
aboriginally	@aboriginally- xem aboriginal
aborigines	æbə''ridʤini:z/* danh từ số nhiều- thổ dân=indians are the aborigines of america+ người da đỏ là thổ dân của châu mỹ- thổ sảnæbə''ridʤini:z/* danh từ số nhiều- thổ dân=indians are the aborigines of america+ người da đỏ là thổ dân của châu mỹ- thổ sản
abort	bỏ dở thui* ngoại động từ- làm sẩy thai phá thai@abort- (tech) hủy bỏ ngưng nửa chừng bỏ dở
aborted	bỏ dở thui</q></n></i></f></c><c><f><i><n><q>@abort /ə''bɔ:t/* nội động từ- sẩy thai; đẻ non ((nghĩa đen) &amp; (nghĩa bóng))- (sinh vật học) không phát triển thui* ngoại động từ- làm sẩy thai phá thai@abort- (tech) hủy bỏ ngưng nửa chừng bỏ dở
aborticide	@aborticide /ə''bɔ:tisaid/* danh từ- thuốc giết thai
abortifacient	làm sẩy thai* danh từ- thuốc phá thai làm sẩy thai* danh từ- thuốc phá thai
abortifacients	làm sẩy thai* danh từ- thuốc phá thai làm sẩy thai* danh từ- thuốc phá thai
abortin	@abortin* danh từ- chất sẩy thai; abotin
aborting	bỏ dở thui* ngoại động từ- làm sẩy thai phá thai@abort- (tech) hủy bỏ ngưng nửa chừng bỏ dở
abortion	ý đồ...)- (sinh vật học) tình trạng phát triển không đầy đủ sự phá thai; sự nạo thai- người lùn tịt; đứa bé đẻ non vật đẻ non; vật dị dạng quái thai- sự chết non chết yểu sự sớm thất bại (của một kế hoạch ý đồ...)- (sinh vật học) tình trạng phát triển không đầy đủ
abortion mechanism	@abortion mechanism- (tech) cơ năng bỏ dở
abortionist	@abortionist /ə''bɔ:ʃənist/* danh từ- người phá thai
abortionists	@abortionist /ə''bɔ:ʃənist/* danh từ- người phá thai
abortions	ý đồ...)- (sinh vật học) tình trạng phát triển không đầy đủ sự phá thai; sự nạo thai- người lùn tịt; đứa bé đẻ non vật đẻ non; vật dị dạng quái thai- sự chết non chết yểu sự sớm thất bại (của một kế hoạch ý đồ...)- (sinh vật học) tình trạng phát triển không đầy đủ
abortive	chết non chết yểu; sớm thất bại=an abortive plan+ một kế hoạch sớm thất bại- (sinh vật học) không phát triển đầy đủ=an abortive organ+ một cơ quan không phát triển đầy đủ@abortive- (tech) bỏ dở chết non chết yểu; sớm thất bại=an abortive plan+ một kế hoạch sớm thất bại- (sinh vật học) không phát triển đầy đủ=an abortive organ+ một cơ quan không phát triển đầy đủ@abortive- (tech) bỏ dở
abortive subexit	@abortive subexit- (tech) lối thoát phụ khi bỏ dở
abortively	@abortively* phó từ- non yểu
abortiveness	sự chết non chết yểu- (sinh vật học) sự không phát triển đầy đủ sự chết non chết yểu- (sinh vật học) sự không phát triển đầy đủ
aborts	bỏ dở thui* ngoại động từ- làm sẩy thai phá thai@abort- (tech) hủy bỏ ngưng nửa chừng bỏ dở
aboulia	@aboulia /ə''bauliə/ (abulia) /ə''bu:ljə/* danh từ- (y học) chứng mất ý chí
abound	đầy dẫy=coal abounds in our country+ than đá có rất nhiều ở nước ta=to abound in courage+ có thừa can đảm with) có rất nhiều có thừa nhan nhản lúc nhúc đầy dẫy=coal abounds in our country+ than đá có rất nhiều ở nước ta=to abound in courage+ có thừa can đảm
abounded	đầy dẫy=coal abounds in our country+ than đá có rất nhiều ở nước ta=to abound in courage+ có thừa can đảm with) có rất nhiều có thừa nhan nhản lúc nhúc đầy dẫy=coal abounds in our country+ than đá có rất nhiều ở nước ta=to abound in courage+ có thừa can đảm
abounding	đầy dẫy=coal abounds in our country+ than đá có rất nhiều ở nước ta=to abound in courage+ có thừa can đảm phong phú thừa thãi</q></n></i></f></c><c><f><i><n><q>@abound /ə''baund/* nội động từ- (+ in with) có rất nhiều có thừa nhan nhản lúc nhúc đầy dẫy=coal abounds in our country+ than đá có rất nhiều ở nước ta=to abound in courage+ có thừa can đảm
abounds	đầy dẫy=coal abounds in our country+ than đá có rất nhiều ở nước ta=to abound in courage+ có thừa can đảm with) có rất nhiều có thừa nhan nhản lúc nhúc đầy dẫy=coal abounds in our country+ than đá có rất nhiều ở nước ta=to abound in courage+ có thừa can đảm
about	đối với- a.five per cent chừng trăm phần trăm quanh quẩn đây đó rải rác=he is somewhere about+ anh ta ở quanh quẩn đâu đó=rumours are about+ đây đó có tiếng đồn (về việc gì)- đằng sau=about turn!+ đằng sau quay- khoảng chừng gần=about forty+ khoảng 40=it is about two o''clock+ bây giờ khoảng chừng hai giờ- vòng=to go a long way about+ đi đường vòng xa!about and about- (từ mỹnghĩa mỹ) rất giống nhau!to be about- bận (làm gì)- đã dậy được (sau khi ốm)- có mặt!about right- đúng đúng đắn- tốt được* giới từ- về=to know much about vietnam+ biết nhiều về việt nam=what shall we write about?+ chúng ta sẽ viết về cái gì bây giờ?- quanh quất quanh quẩn đây đó rải rác=to walk about the garden+ đi quanh quẩn trong vườn- xung quanh=the trees about the pound+ cây cối xung quanh ao- khoảng chừng vào khoảng=about nightfall+ vào khoảng chập tối- bận đang làm (gì...)=he is still about it+ hắn hãy còn bận làm việc đó=to go about one''s work+ đi làm- ở (ai); trong người (ai) theo với (ai)=i have all the documents about me+ tôi có mang theo đầy đủ tài liệu=there''s something nice about him+ ở anh ta có một cái gì đó hay hay!to be about to- sắp sắp sửa=the train is about to start+ xe lửa sắp khởi hành=man about town+ tay ăn chơi tay giao thiệp rộng=what are you about?+ anh muốn gì? anh cần gì?- (từ hiếmnghĩa hiếm) anh đang làm gì đấy?!what about?- (xem) what* ngoại động từ- lái (thuyền...) theo hướng khác@about- độ chừng; xung quanh; nói về đối với- a.five per cent chừng trăm phần trăm
about-face	sự thay đổi hẳn ý kiến* nội động từ- (quân sự) quay đằng sau sự thay đổi hẳn thái độ sự thay đổi hẳn ý kiến* nội động từ- (quân sự) quay đằng sau
about-sledge	sledʤ/* danh từ- (kỹ thuật) búa tạsledʤ/* danh từ- (kỹ thuật) búa tạ
about-turn	sự đổi ý sự đổi ý
about...	@about...- (tech) về...
above	cao hơn trên đỉnh đầu=clouds are drifting above+ mây đang bay trên đỉnh đầu- ở trên=as was started above+ như đã nói rõ ở trên=as was remarked above+ như đã nhận xét ở trên- trên thiên đường- lên trên; ngược dòng (sông); lên gác=a staircase leading above+ cầu thang lên gác=you will find a bridge above+ đi ngược dòng sông anh sẽ thấy một cái cầu- trên hơn=they were all men of fifty and above+ họ tất cả đều năm mươi và trên năm mươi tuổi=over and above+ hơn nữa vả lại ngoài ra* giới từ- ở trên=the plane was above the clouds+ máy bay ở trên mây- quá vượt cao hơn=this work is above my capacity+ công việc này quá khả năng tôi=he is above all the other boys in his class+ nó vượt tất cả những đứa trẻ khác trong lớp- trên hơn=to value independence and freedom above all+ quý độc lập và tự do hơn tất cả=above all+ trước hết là trước nhất là trước tiên là!above oneself- lên mặt- phởn bốc=to keep one''s head above water+ giữ cho mình được an toàn; giữ khỏi mang công mắc nợ* tính từ- ở trên kể trên nói trên=the above facts+ những sự việc kể trên=the above statements+ những lời phát biểu ở trên* danh từ- the above cái ở trên; điều kể trên; điều nói trên@above- ở trên cao hơn
above-board	không giấu giếm không che đậy không giấu giếm
above-cited	đã nhắc đến đã nhắc đến
above-ground	graund/* tính từ- ở trên mặt đất- còn sống trên đời* phó từ- ở trên mặt đất- lúc còn sống ở trên đờigraund/* tính từ- ở trên mặt đất- còn sống trên đời* phó từ- ở trên mặt đất- lúc còn sống ở trên đời
above-mentioned	nói trên nói trên
above-named	@above-named* tính từ- đã nói ở trên
aboveboard	không giấu giếm adv- thẳng thắn không che đậy không giấu giếm
aboveground	@aboveground* tính từ- ở trên mặt đất- còn sống trên đời* phó từ- ở trên mặt đất- lúc còn sống ở trên đời
abovementioned	nói trên nói trên
abracadabra	æbrəkə''dæbrə/* danh từ- câu thần chú- lời nói khó hiểuæbrəkə''dæbrə/* danh từ- câu thần chú- lời nói khó hiểu
abrachia	@abrachia* danh từ- tật thiếu tay
abrachiate	@abrachiate* tính từ- thiếu tay
abrachius	@abrachius* danh từ- quái thai không tay
abradant	mài mòn* danh từ- chất mài mòn mài mòn* danh từ- chất mài mòn
abradants	mài mòn* danh từ- chất mài mòn mài mòn* danh từ- chất mài mòn
abrade	@abrade /ə''breid/* ngoại động từ- làm trầy (da); cọ xơ ra- (kỹ thuật) mài mòn
abraded	@abrade /ə''breid/* ngoại động từ- làm trầy (da); cọ xơ ra- (kỹ thuật) mài mòn
abrades	@abrade /ə''breid/* ngoại động từ- làm trầy (da); cọ xơ ra- (kỹ thuật) mài mòn
abrading	@abrade /ə''breid/* ngoại động từ- làm trầy (da); cọ xơ ra- (kỹ thuật) mài mòn
abranchial	@abranchial /ə''bræɳkiəl/ (abranchiate) /ə''bræɳkiit/* tính từ- (động vật học) không mang
abranchiate	@abranchiate /ə''bræɳkiəl/ (abranchiate) /ə''bræɳkiit/* tính từ- (động vật học) không mang
abrase	@abrase* ngoại động từ- cắt mất
abrasion	(kỹ thuật) sự mài mònđịa chất) (kỹ thuật) sự mài mòn
abrasions	(kỹ thuật) sự mài mònđịa chất) (kỹ thuật) sự mài mòn
abrasive	@abrasive /ə''breisiv/* tính từ- làm trầy (da)- để cọ xơ ra- để mài mòn* danh từ- chất mài mòn
abrasives	@abrasive /ə''breisiv/* tính từ- làm trầy (da)- để cọ xơ ra- để mài mòn* danh từ- chất mài mòn
abreact	@abreact* ngoại động từ- giải toả mặc cảm
abreacted	@abreact* ngoại động từ- giải toả mặc cảm
abreacting	@abreact* ngoại động từ- giải toả mặc cảm
abreaction	@abreaction* danh từ- (y học) sự giải toả mặc cảm
abreacts	@abreact* ngoại động từ- giải toả mặc cảm
abreast	bên cạnh=to walk abreast+ đi sóng hàng với nhau=abreast the times+ theo kịp thời đại!to keep abreast of (with)- (xem) keep sóng hàng ngang nhau; sát nhau sát vai bên cạnh=to walk abreast+ đi sóng hàng với nhau=abreast the times+ theo kịp thời đại!to keep abreast of (with)- (xem) keep
abrego	@abrego* danh từ- (động vật) cá ngừ vây dài
abridge	làm tắt cô gọn tóm tắt- hạn chế giảm bớt (quyền...)- lấy tước=to abridge somebody of his rights+ tước quyền lợi của ai@abridge- rút gọn làm tắt
abridged	làm tắt cô gọn tóm tắt- hạn chế giảm bớt (quyền...)- lấy tước=to abridge somebody of his rights+ tước quyền lợi của ai@abridge- rút gọn làm tắt
abridgement	sự giảm bớt sự cô gọn sự tóm tắt; bài tóm tắt sách sách tóm tắt- sự hạn chế sự giảm bớt
abridgements	sự giảm bớt sự cô gọn sự tóm tắt; bài tóm tắt sách sách tóm tắt- sự hạn chế sự giảm bớt
abridger	@abridger- xem abridge
abridges	làm tắt cô gọn tóm tắt- hạn chế giảm bớt (quyền...)- lấy tước=to abridge somebody of his rights+ tước quyền lợi của ai@abridge- rút gọn làm tắt
abridging	tước=to abridge somebody of his rights+ tước quyền lợi của ai@abridge- rút gọn cô gọn tóm tắt- hạn chế giảm bớt (quyền...)- lấy tước=to abridge somebody of his rights+ tước quyền lợi của ai@abridge- rút gọn làm tắt</q></n></i></f></c>');
abridgments	sự giảm bớt sự cô gọn sự tóm tắt; bài tóm tắt sách sách tóm tắt- sự hạn chế sự giảm bớt
abroach	khui một thùng rượu khui một thùng rượu
abroad	hoàn toàn lầm lẫn!from abroad- từ nước ngoài=these machines were brought from abroad+ những chiếc máy này mang từ nước ngoài vào ra nước ngoài=to live abroad+ sống ở nước ngoài=to go abroad+ đi ra nước ngoài- khắp nơi đang truyền đi khắp nơi=there is a runmour abroad that...+ khắp nơi đang có tin đồn rằng...=the schooimaster is abroad+ việc học hành bây giờ đang trở thành phổ biến- ngoài trời (đối với trong nhà)=life abroad is very healthy+ sống ở ngoài trời tốt cho sức khoẻ- (thông tục) nghĩ sai nhầm tưởng lầm=to be all abroad+ nghĩ sai hoàn toàn hoàn toàn lầm lẫn!from abroad- từ nước ngoài=these machines were brought from abroad+ những chiếc máy này mang từ nước ngoài vào
abrogable	@abrogable* tính từ- có thể hủy bỏ
abrogate	thủ tiêu; bài trừ=backward customs musr be abrogated+ phải bài trừ những hủ tục=to abrogate a law+ huỷ bỏ một đạo luật huỷ bỏ thủ tiêu; bài trừ=backward customs musr be abrogated+ phải bài trừ những hủ tục=to abrogate a law+ huỷ bỏ một đạo luật
abrogated	thủ tiêu; bài trừ=backward customs musr be abrogated+ phải bài trừ những hủ tục=to abrogate a law+ huỷ bỏ một đạo luật huỷ bỏ thủ tiêu; bài trừ=backward customs musr be abrogated+ phải bài trừ những hủ tục=to abrogate a law+ huỷ bỏ một đạo luật
abrogates	thủ tiêu; bài trừ=backward customs musr be abrogated+ phải bài trừ những hủ tục=to abrogate a law+ huỷ bỏ một đạo luật huỷ bỏ thủ tiêu; bài trừ=backward customs musr be abrogated+ phải bài trừ những hủ tục=to abrogate a law+ huỷ bỏ một đạo luật
abrogating	thủ tiêu; bài trừ=backward customs musr be abrogated+ phải bài trừ những hủ tục=to abrogate a law+ huỷ bỏ một đạo luật huỷ bỏ thủ tiêu; bài trừ=backward customs musr be abrogated+ phải bài trừ những hủ tục=to abrogate a law+ huỷ bỏ một đạo luật
abrogation	sự thủ tiêu; sự bài trừæbrou''geiʃn/* danh từ- sự bãi bỏ sự huỷ bỏ sự thủ tiêu; sự bài trừ
abrogations	sự thủ tiêu; sự bài trừæbrou''geiʃn/* danh từ- sự bãi bỏ sự huỷ bỏ sự thủ tiêu; sự bài trừ
abrogative	@abrogative* tính từ- bị hủy bỏ
abrupt	bị chặt cụt (cây...) đột ngột; vội vã=an abrupt turn+ chỗ ngoặc bất ngờ=an abrupt departure+ sự ra đi vội vã (đột ngột)- cộc lốc lấc cấc thô lỗ=an abrupt answers+ câu trả lời cộc lốc=abrupt manners+ cách cư xử lấc cấc- dốc đứng hiểm trở gian nan=abrupt coast+ bờ biển dốc đứng=the road to science is very abrupt+ con đường đi tới khoa học rất gian nan- trúc trắc rời rạc (văn)- bị đốn bị chặt cụt; như thể bị đốn bị chặt cụt (cây...)
abrupt junction	@abrupt junction- (tech) tiếp giáp dốc thẳng đứng
abrupt junction diode	@abrupt junction diode- (tech) đèn hai cực tiếp giáp dốc thẳng đứng
abruption	sự gãy rời sự gãy rời
abruptly	xấc xược đột ngột- lấc cấc xấc xược
abruptness	sự rời rạc (văn) sự đột ngột sự vội vã- tính cộc lốc tính lấc cấc; sự thô lỗ- thế dốc đứng sự hiểm trở; sự gian nan- sự trúc trắc sự rời rạc (văn)
abscess	@abscess /''æbsis/* danh từ- (y học) áp xe- (kỹ thuật) chỗ rỗ (ở kim loại)
abscessed	@abscessed* tính từ- (y học) bị áp-xe- bị rỗ
abscesses	@abscess /''æbsis/* danh từ- (y học) áp xe- (kỹ thuật) chỗ rỗ (ở kim loại)
abscise	bị cắt ra bị cắt ra
absciss	@absciss /æb''sis/* danh từ abscisses- (toán học) độ hoành
abscissa	@abscissa- (econ) hoành độ+ giá trị trên trục hoành (trục x) của một điểm trên đồ thị hai chiều.
abscissae	số nhiều abscissae- (như) absciss@abscissa- (tech) hoành độ số nhiều abscissae- (như) absciss</q></n></i></f></c><c><f><i><n><q>@abscissa- (econ) hoành độ+ giá trị trên trục hoành (trục x) của một điểm trên đồ thị hai chiều.</q></n></i></f></c><c><f><i><n><q>@abscissa /æb''sisə/* danh từ số nhiều abscissae- (như) absciss@abscissa- (tech) hoành độ
abscissas	số nhiều abscissae- (như) absciss@abscissa- (tech) hoành độ số nhiều abscissae- (như) absciss@abscissa- (tech) hoành độ
abscisse	số nhiều abscisses- (như) absciss số nhiều abscisses- (như) absciss
abscission	@abscission /æb''siʤn/* danh từ- (y học) sự cắt bỏ
abscissions	@abscission /æb''siʤn/* danh từ- (y học) sự cắt bỏ
abscond	bỏ trốn- trốn tránh pháp luật bỏ trốn- trốn tránh pháp luật
absconded	bỏ trốn- trốn tránh pháp luật bỏ trốn- trốn tránh pháp luật
absconder	người bỏ trốn- người trốn tránh pháp luật người bỏ trốn- người trốn tránh pháp luật
absconding	bỏ trốn- trốn tránh pháp luật bỏ trốn- trốn tránh pháp luật
absconds	bỏ trốn- trốn tránh pháp luật bỏ trốn- trốn tránh pháp luật
abseil	tụt xuống tụt xuống
absence	sự không có=to carry out production in the absence of necessary machines+ sản xuất trong tình trạng thiếu những máy móc cần thiết- sự điểm danh=absence of mind+ sự lơ đãng=absence without leave+ sự nghỉ không phép!leave of absence- (xem) leave sự nghỉ (học) sự đi vắng; thời gian vắng mặt lúc đi vắng=to have a long absence from school+ nghỉ học lâu- sự thiếu sự không có=to carry out production in the absence of necessary machines+ sản xuất trong tình trạng thiếu những máy móc cần thiết- sự điểm danh=absence of mind+ sự lơ đãng=absence without leave+ sự nghỉ không phép!leave of absence- (xem) leave
absence or presence	không hay có không hay có
absences	sự không có=to carry out production in the absence of necessary machines+ sản xuất trong tình trạng thiếu những máy móc cần thiết- sự điểm danh=absence of mind+ sự lơ đãng=absence without leave+ sự nghỉ không phép!leave of absence- (xem) leave sự nghỉ (học) sự đi vắng; thời gian vắng mặt lúc đi vắng=to have a long absence from school+ nghỉ học lâu- sự thiếu sự không có=to carry out production in the absence of necessary machines+ sản xuất trong tình trạng thiếu những máy móc cần thiết- sự điểm danh=absence of mind+ sự lơ đãng=absence without leave+ sự nghỉ không phép!leave of absence- (xem) leave
absent	nghỉ=to absent oneself from school+ nghỉ học=to absent oneself from work+ vắng mặt không đi làm đi vắng nghỉ- lơ đãng=an absent air+ vẻ lơ đãng=to answer in an absent way+ trả lời một cách lơ đãng* động từ phãn thân- vắng mặt đi vắng nghỉ=to absent oneself from school+ nghỉ học=to absent oneself from work+ vắng mặt không đi làm
absent service	@absent service- (tech) dịch vụ (truyền đạt lúc) vắng mặt
absent subscriber service	@absent subscriber service- (tech) dịch vụ thuê bao vắng mặt
absent transfer	@absent transfer- (tech) truyền đạt vắng mặt
absent-minded	@absent-minded /''æbsənt''maindid/* tính từ- lơ đãng
absent-mindedly	@absent-mindedly* phó từ- đãng trí
absent-mindedness	tính lơ đãng tính lơ đãng
absentation	không chú ý trạng thái lơ đãng không chú ý
absented	nghỉ=to absent oneself from school+ nghỉ học=to absent oneself from work+ vắng mặt không đi làm đi vắng nghỉ- lơ đãng=an absent air+ vẻ lơ đãng=to answer in an absent way+ trả lời một cách lơ đãng* động từ phãn thân- vắng mặt đi vắng nghỉ=to absent oneself from school+ nghỉ học=to absent oneself from work+ vắng mặt không đi làm
absentee	người nghỉ- địa chủ không ở thường xuyên tại nơi có ruộng đấtæbsən''ti:/* danh từ- người vắng mặt người đi vắng người nghỉ- địa chủ không ở thường xuyên tại nơi có ruộng đất
absentee ballot	@absentee ballot* danh từ- việc bỏ phiếu trước của những cử tri nào không thể có mặt vào ngày bầu cử chính thức
absentee landlord	thu tiền thuê và quản lý việc kinh doanh của mình thông qua trung gian hay người đại diện. thu tiền thuê và quản lý việc kinh doanh của mình thông qua trung gian hay người đại diện.
absenteeism	mặc dù các điều khoản của hợp đồng lao động yêu cầu người lao động phải đi làm và hợp đồng vẫn còn giá trị. sự nghỉ làm không có lý do+ sự nghỉ làm mặc dù các điều khoản của hợp đồng lao động yêu cầu người lao động phải đi làm và hợp đồng vẫn còn giá trị.
absentees	người nghỉ- địa chủ không ở thường xuyên tại nơi có ruộng đấtæbsən''ti:/* danh từ- người vắng mặt người đi vắng người nghỉ- địa chủ không ở thường xuyên tại nơi có ruộng đất
absenting	nghỉ=to absent oneself from school+ nghỉ học=to absent oneself from work+ vắng mặt không đi làm đi vắng nghỉ- lơ đãng=an absent air+ vẻ lơ đãng=to answer in an absent way+ trả lời một cách lơ đãng* động từ phãn thân- vắng mặt đi vắng nghỉ=to absent oneself from school+ nghỉ học=to absent oneself from work+ vắng mặt không đi làm
absently	@absently /''æbsəntli/* phó từ- lơ đãng
absents	nghỉ=to absent oneself from school+ nghỉ học=to absent oneself from work+ vắng mặt không đi làm đi vắng nghỉ- lơ đãng=an absent air+ vẻ lơ đãng=to answer in an absent way+ trả lời một cách lơ đãng* động từ phãn thân- vắng mặt đi vắng nghỉ=to absent oneself from school+ nghỉ học=to absent oneself from work+ vắng mặt không đi làm
absinth	cây ngải đắng- tinh dầu apxin- rượu apxin cây ngải đắng- tinh dầu apxin- rượu apxin
absinthe	cây ngải đắng- tinh dầu apxin- rượu apxin cây ngải đắng- tinh dầu apxin- rượu apxin
absinthian	@absinthian /æb''sinθiən/* tính từ- (thuộc) apxin
absolutary	@absolutary* tính từ- xá tội; tha tội
absolute	chắc chắn=absolute evidence+ chứng cớ xác thực- vô điều kiện=an absolute promise+ lời hứa vô điều kiện@absolute- (tech) tuyệt đối@absolute- tuyệt đối // hình tuyệt đối hoàn toàn; thuần tuý nguyên chất=absolute confidence in the party''s leadership+ sự tin tưởng tuyệt đối vào sự lãnh đạo của đảng=absolute music+ âm nhạc thuần tuý=absolute alcohol+ rượu nguyên chất- chuyên chế độc đoán=absolute monarchy+ nền quân chủ chuyên chế- xác thực đúng sự thực chắc chắn=absolute evidence+ chứng cớ xác thực- vô điều kiện=an absolute promise+ lời hứa vô điều kiện@absolute- (tech) tuyệt đối@absolute- tuyệt đối // hình tuyệt đối
absolute address	@absolute address- (tech) địa chỉ tuyệt đối
absolute address variable	@absolute address variable- (tech) biến số địa chỉ tuyệt đối
absolute addressing	@absolute addressing- (tech) phương pháp định địa chỉ tuyệt đối
absolute advantage	@absolute advantage- (econ) lợi thế tuyệt đối.+ xem comparative advantage.
absolute altimeter	@absolute altimeter- (tech) máy đo độ cao tuyệt đối
absolute ampere	@absolute ampere- (tech) ampe tuyệt đối
absolute coordinate	@absolute coordinate- (tech) tọa độ tuyệt đối
absolute cost advantage	vì thế các hãng này có thể duy trì chi phí trung bình thấp hơn so với các hãng mới nhập ngành không phụ thuộc vào mức sản lượng. (xem barriers to entry) vì thế các hãng này có thể duy trì chi phí trung bình thấp hơn so với các hãng mới nhập ngành không phụ thuộc vào mức sản lượng. (xem barriers to entry)
absolute data	@absolute data- (tech) dữ kiện tuyệt đối
absolute electrometer	@absolute electrometer- (tech) điện tĩnh kế tuyệt đối
absolute element	@absolute element- (tech) phần tử tuyệt đối
absolute error	@absolute error- (tech) sai số tuyệt đối
absolute expression	@absolute expression- (tech) biểu thức tuyệt đối
absolute file specifier	@absolute file specifier- (tech) tên gọi tuyệt đối của tập tin
absolute galvanometer	@absolute galvanometer- (tech) điện kế tuyệt đối
absolute generation number	@absolute generation number- (tech) số thế hệ tuyệt đối
absolute income hypothesis	@absolute income hypothesis- (econ) giả thuyết thu nhập tuyệt đối.+ giả thuyết này cho rằng các chi phí cho tiêu dùng (c) là một hàm số của thu nhập khả dụng của cá nhân (yd): c = c (yd).
absolute instruction	chỉ thị ngôn ngữ máy chỉ thị ngôn ngữ máy
absolute level	@absolute level- (tech) mức tuyệt đối
absolute loader	@absolute loader- (tech) bộ nạp tuyệt đối
absolute majority	tuyệt đại đa số tuyệt đại đa số
absolute monopoly	@absolute monopoly- (econ) độc quyền tuyệt đối.+ xem monopoly.
absolute move	@absolute move- (tech) di chuyển tuyệt đối
absolute movement	@absolute movement- (tech) di động tuyệt đối
absolute name	@absolute name- (tech) tên tuyệt đối
absolute ohm	@absolute ohm- (tech) ohm tuyệt đối
absolute order	@absolute order- (tech) thứ tự tuyệt đối
absolute path	@absolute path- (tech) đường tuyệt đối
absolute path name	@absolute path name- (tech) tên đường tuyệt đối
absolute permeability	@absolute permeability- (tech) độ từ thẩm tuyệt đối
absolute permittivity	@absolute permittivity- (tech) hằng số điện môi tuyệt đối
absolute phase	@absolute phase- (tech) vị tướng/pha tuyệt đối
absolute plotting	@absolute plotting- (tech) phép vẽ dùng vị trí tuyệt đối
absolute plotting unit	@absolute plotting unit- (tech) đơn vị vẽ tuyệt đối
absolute position	@absolute position- (tech) vị trí tuyệt đối
absolute prices	dịch vụ được biểu diễn trực tiếp dưới dạng số lượng của đơn vị tiền tệ. xem price dịch vụ được biểu diễn trực tiếp dưới dạng số lượng của đơn vị tiền tệ. xem price
absolute scarcity	@absolute scarcity- (econ) khan hiếm tuyệt đối .+ xem scarcity
absolute temperature	@absolute temperature- (tech) nhiệt độ tuyệt đối
absolute tense	@absolute tense- (tech) thời (chế) tuyệt đối [nb]
absolute term	@absolute term- (tech) số hạng tuyệt đối
absolute unit	@absolute unit- (tech) đơn vị tuyệt đối
absolute value	@absolute value- (econ) giá trị tuyệt đối.+ giá trị của một biến bỏ qua dấu của nó.
absolute value computer	@absolute value computer- (tech) máy điện toán trị tuyệt đối
absolute value function	@absolute value function- (tech) hàm số trị tuyệt đối
absolute vector	@absolute vector- (tech) véctơ tuyệt đối
absolute volt	@absolute volt- (tech) volt tuyệt đối
absolute zero	@absolute zero- (tech) số không tuyệt đối
absolutely	đúng như vậy@absolutely- một cách tuyệt đối hoàn toàn=to be absolutely wrong+ hoàn toàn sai lầm hoàn toàn trái- chuyên chế độc đoán=to govern absolutely+ cai trị một cách chuyên chế- vô điều kiện- (thông tục) nhất định chắc chắn; tất nhiên; hoàn toàn như vậy đúng như vậy@absolutely- một cách tuyệt đối
absolutely convergent	@absolutely convergent- (tech) hội tụ tuyệt đối
absolutely noncircular attribute	@absolutely noncircular attribute- (tech) thuộc tính phi tuần hoàn tuyệt đối
absolutely noncircular attribute grammar	@absolutely noncircular attribute grammar- (tech) văn phạm thuộc tính phi tuần hoàn tuyệt đối
absoluteness	tính hoàn toàn tính hoàn toàn
absolutes	chắc chắn=absolute evidence+ chứng cớ xác thực- vô điều kiện=an absolute promise+ lời hứa vô điều kiện@absolute- (tech) tuyệt đối@absolute- tuyệt đối // hình tuyệt đối hoàn toàn; thuần tuý nguyên chất=absolute confidence in the party''s leadership+ sự tin tưởng tuyệt đối vào sự lãnh đạo của đảng=absolute music+ âm nhạc thuần tuý=absolute alcohol+ rượu nguyên chất- chuyên chế độc đoán=absolute monarchy+ nền quân chủ chuyên chế- xác thực đúng sự thực chắc chắn=absolute evidence+ chứng cớ xác thực- vô điều kiện=an absolute promise+ lời hứa vô điều kiện@absolute- (tech) tuyệt đối@absolute- tuyệt đối // hình tuyệt đối
absolution	sự miễn xá- (tôn giáo) sự xá tộiæbsə''lu:ʃn/* danh từ- (pháp lý) sự tha tội sự miễn xá- (tôn giáo) sự xá tội
absolutions	sự miễn xá- (tôn giáo) sự xá tộiæbsə''lu:ʃn/* danh từ- (pháp lý) sự tha tội sự miễn xá- (tôn giáo) sự xá tội
absolutism	chính thể chuyên chế chính thể chuyên chế
absolutist	@absolutist /''æbsəlu:tist/* danh từ- (chính trị) người theo chính thể chuyên chế
absolutistic	@absolutistic- xem absolutism
absolutists	@absolutist /''æbsəlu:tist/* danh từ- (chính trị) người theo chính thể chuyên chế
absolvable	@absolvable- xem absolve
absolve	giải bùa cho ai xá tội tuyên án vô tội; miễn trách=to absolve someone from blame+ miễn trách ai tuyên bố ai không có lỗi=to be absolved from the guilt+ được tuyên án vô tội- giải giải phóng cởi gỡ=to absolve someone from a spell+ giải cho ai khỏi bị bùa mê giải bùa cho ai
absolved	giải bùa cho ai xá tội tuyên án vô tội; miễn trách=to absolve someone from blame+ miễn trách ai tuyên bố ai không có lỗi=to be absolved from the guilt+ được tuyên án vô tội- giải giải phóng cởi gỡ=to absolve someone from a spell+ giải cho ai khỏi bị bùa mê giải bùa cho ai
absolver	@absolver- xem absolve
absolves	giải bùa cho ai xá tội tuyên án vô tội; miễn trách=to absolve someone from blame+ miễn trách ai tuyên bố ai không có lỗi=to be absolved from the guilt+ được tuyên án vô tội- giải giải phóng cởi gỡ=to absolve someone from a spell+ giải cho ai khỏi bị bùa mê giải bùa cho ai
absolving	giải bùa cho ai xá tội tuyên án vô tội; miễn trách=to absolve someone from blame+ miễn trách ai tuyên bố ai không có lỗi=to be absolved from the guilt+ được tuyên án vô tội- giải giải phóng cởi gỡ=to absolve someone from a spell+ giải cho ai khỏi bị bùa mê giải bùa cho ai
absonant	trái với- không hợp lý không hoà hợp- (+ to from) không hợp với trái với- không hợp lý
absorb	hút thu hút thu (nước)=dry sand absorb water+ cát khô hút nước- hấp thu=youths always absorb new ideas+ thanh niên luôn luôn hấp thu những tư tưởng mới- miệt mài mê mải chăm chú; lôi cuốn thu hút sự chú ý=to be absorbed in thought+ mãi suy nghĩ=to be absorbed in the study of marxism-leninism+ miệt mài nghiên cứu chủ nghĩa mác-lênin@absorb- hấp thu hút thu
absorbability	sɔ:bə''biliti/* danh từ- khả năng hút thusɔ:bə''biliti/* danh từ- khả năng hút thu
absorbable	@absorbable /əb''sɔ:bəbl/* tính từ- có thể nuốt được; có thể bị hút- có thể hút thu được; có thể bị hút thu
absorbed	hút thu mê mải say mê chăm chú=with absorbed interest+ chú ý miệt mài; say mê thích thú</q></n></i></f></c><c><f><i><n><q>@absorb /əb''sɔ:b/* ngoại động từ- hút hút thu (nước)=dry sand absorb water+ cát khô hút nước- hấp thu=youths always absorb new ideas+ thanh niên luôn luôn hấp thu những tư tưởng mới- miệt mài mê mải chăm chú; lôi cuốn thu hút sự chú ý=to be absorbed in thought+ mãi suy nghĩ=to be absorbed in the study of marxism-leninism+ miệt mài nghiên cứu chủ nghĩa mác-lênin@absorb- hấp thu hút thu
absorbed photon	@absorbed photon- (tech) quang tử hấp thu
absorbed power	@absorbed power- (tech) công suất hấp thu
absorbedly	chăm chú mê mải; say mê chăm chú
absorbedness	@absorbedness- xem absorbed
absorbefacient	thuốc làm tansɔ:bi''feiʃənt/* tính từ- (y học) làm tiêu đi làm tan đi* danh từ- (y học) thuốc làm tiêu thuốc làm tan
absorbencies	@absorbency- xem absorbent
absorbency	@absorbency- xem absorbent
absorbent	thấm hút=absorbent cotton wood+ bông hút nước* danh từ- chất hút thu; máy hút thu- (thực vật học); (động vật học) cơ quan hút thu (các chất dinh dưỡng) thấm hút=absorbent cotton wood+ bông hút nước* danh từ- chất hút thu; máy hút thu- (thực vật học); (động vật học) cơ quan hút thu (các chất dinh dưỡng)
absorber	@absorber /əb''sɔ:bə/* danh từ- (kỹ thuật) thiết bị hút thu- cái giảm xóc (ô tô)@absorber- (tech) bộ hấp thu; bộ đệm
absorbers	@absorber /əb''sɔ:bə/* danh từ- (kỹ thuật) thiết bị hút thu- cái giảm xóc (ô tô)@absorber- (tech) bộ hấp thu; bộ đệm
absorbing	hút thu làm say mê làm say sưa=an absorbing story+ câu chuyện hấp dẫn=to tell the story in an absorbing way+ kể chuyện một cách hấp dẫn</q></n></i></f></c><c><f><i><n><q>@absorb /əb''sɔ:b/* ngoại động từ- hút hút thu (nước)=dry sand absorb water+ cát khô hút nước- hấp thu=youths always absorb new ideas+ thanh niên luôn luôn hấp thu những tư tưởng mới- miệt mài mê mải chăm chú; lôi cuốn thu hút sự chú ý=to be absorbed in thought+ mãi suy nghĩ=to be absorbed in the study of marxism-leninism+ miệt mài nghiên cứu chủ nghĩa mác-lênin@absorb- hấp thu hút thu
absorbing load	@absorbing load- (tech) tải hấp thu
absorbing state	@absorbing state- (tech) trạng thái hấp thu
absorbingly	@absorbingly- xem absorb
absorbs	hút thu hút thu (nước)=dry sand absorb water+ cát khô hút nước- hấp thu=youths always absorb new ideas+ thanh niên luôn luôn hấp thu những tư tưởng mới- miệt mài mê mải chăm chú; lôi cuốn thu hút sự chú ý=to be absorbed in thought+ mãi suy nghĩ=to be absorbed in the study of marxism-leninism+ miệt mài nghiên cứu chủ nghĩa mác-lênin@absorb- hấp thu hút thu
absorptance	@absorptance- (tech) độ hấp thu
absorption	sự thu hút sự hút thu- sự say mê miệt mài sự mê mải@absorption- (tech) hấp thu; đệm; làm nhụt (d)@absorption- sự hấp thu sự thu hút
absorption approach	@absorption approach- (econ) phương pháp hấp thu.+ phương pháp phân tích tác động của sự phá giá hoặc giảm tỷ giá hối đoái của một nước đối với cán cân thương mại.
absorption cell	@absorption cell- (tech) tổ hấp thu
absorption circuit	@absorption circuit- (tech) mạch hấp thu
absorption coefficient	@absorption coefficient- (tech) hệ số hấp thu
absorption current	@absorption current- (tech) dòng hấp thu
absorption factor	@absorption factor- (tech) hệ số hấp thu
absorption index	@absorption index- (tech) chỉ số hấp thu
absorption law	@absorption law- (tech) định luật hấp thu
absorption loss	@absorption loss- (tech) tổn hao hấp thu
absorption peak	@absorption peak- (tech) đĩnh hấp thu
absorption spectrum	@absorption spectrum- (tech) quang phổ hấp thu
absorption trap	@absorption trap- (tech) cái bẫy hấp thu
absorption wavemeter	@absorption wavemeter- (tech) máy đo sóng loại hấp thu
absorptions	sự thu hút sự hút thu- sự say mê miệt mài sự mê mải@absorption- (tech) hấp thu; đệm; làm nhụt (d)@absorption- sự hấp thu sự thu hút
absorptive	@absorptive /əb''sɔ:ptiv/* tính từ- hút thu=absorptive power+ khả năng hút thu
absorptive attenuator	@absorptive attenuator- (tech) bộ giảm sóng hấp thu
absorptive modulation	@absorptive modulation- (tech) điều tần hấp thu
absorptive surface	@absorptive surface- (tech) bề mặt hấp thu
absorptive transition	@absorptive transition- (tech) tiếp giáp hấp thu
absorptivity	æbsɔ:p''tiviti/* danh từ- khả năng hút thu@absorptivity- (tech) độ hấp thu; tính hấp thuæbsɔ:p''tiviti/* danh từ- khả năng hút thu@absorptivity- (tech) độ hấp thu; tính hấp thu
absquatulate	@absquatulate* nội động từ- trốn chạy
abstain	tiết chế=to abstain from alcohol+ kiêng rượu- kiêng rượu- (tôn giáo) ăn chay ((cũng) to abstain from meat) kiêng khem tiết chế=to abstain from alcohol+ kiêng rượu- kiêng rượu- (tôn giáo) ăn chay ((cũng) to abstain from meat)
abstained	tiết chế=to abstain from alcohol+ kiêng rượu- kiêng rượu- (tôn giáo) ăn chay ((cũng) to abstain from meat) kiêng khem tiết chế=to abstain from alcohol+ kiêng rượu- kiêng rượu- (tôn giáo) ăn chay ((cũng) to abstain from meat)
abstainer	@abstainer /əb''steinə/* danh từ- người kiêng rượu=a total abstainer+ người kiêng rượu hoàn toàn
abstainers	@abstainer /əb''steinə/* danh từ- người kiêng rượu=a total abstainer+ người kiêng rượu hoàn toàn
abstaining	tiết chế=to abstain from alcohol+ kiêng rượu- kiêng rượu- (tôn giáo) ăn chay ((cũng) to abstain from meat) kiêng khem tiết chế=to abstain from alcohol+ kiêng rượu- kiêng rượu- (tôn giáo) ăn chay ((cũng) to abstain from meat)
abstains	tiết chế=to abstain from alcohol+ kiêng rượu- kiêng rượu- (tôn giáo) ăn chay ((cũng) to abstain from meat) kiêng khem tiết chế=to abstain from alcohol+ kiêng rượu- kiêng rượu- (tôn giáo) ăn chay ((cũng) to abstain from meat)
abstemious	đạm bạc=an abstemiousmeal+ bữa ăn đạm bạc có điều độ- sơ sài đạm bạc=an abstemiousmeal+ bữa ăn đạm bạc
abstemiously	tiết độ điều độ tiết độ
abstemiousness	sự tiết độ sự tiết độ
abstention	@abstention /æb''stenʃn/* danh từ- (+ from) sự kiêng- sự không tham gia bỏ phiếu
abstentions	@abstention /æb''stenʃn/* danh từ- (+ from) sự kiêng- sự không tham gia bỏ phiếu
absterge	làm sạch làm sạch
abstergent	làm sạch* danh từ- (y học) thuốc làm sạch (vết thương) làm sạch* danh từ- (y học) thuốc làm sạch (vết thương)
abstergents	làm sạch* danh từ- (y học) thuốc làm sạch (vết thương) làm sạch* danh từ- (y học) thuốc làm sạch (vết thương)
abstersion	sự làm sạch sự làm sạch
abstersive	làm sạch làm sạch
abstinence	@abstinence- (econ) nhịn chi tiêu.+ một thuật ngữ miêu tả sự cần thiết giảm bớt tiêu dùng hiện tại để tích luỹ tư bản.
abstinency	sự kiêng khem sự kiêng khem
abstinent	@abstinent /''æbstinənt/* tính từ- ăn uống điều độ; kiêng khem
abstinently	@abstinently- xem abstinence
abstract	trích yếu luận án bài diễn văn...)- vật trừu tượng=in the abstract+ trừu tượng lý thuyết* ngoại động từ- trừu tượng hoá- làm đãng trí- rút ra chiết ra tách ra=to abstract butter from milk+ tách bơ ra khỏi sữa- lấy trộm ăn cắp- tóm tắt trích yếu@abstract- (tech) trừu tượng; tóm tắt trích yếu
abstract algebra	@abstract algebra- (tech) đại số học trừu tượng/ đồng điều
abstract journal	báo sao lục [nb] báo sao lục [nb]
abstract noun	sự tự do...) sự tự do...)
abstract semantics	@abstract semantics- (tech) ngữ nghĩa trừu tượng
abstract symbol	@abstract symbol- (tech) ký hiệu trừu tượng
abstract syntax	@abstract syntax- (tech) cú pháp trừu tượng
abstracted	trích yếu luận án bài diễn văn...)- vật trừu tượng=in the abstract+ trừu tượng lý thuyết* ngoại động từ- trừu tượng hoá- làm đãng trí- rút ra chiết ra tách ra=to abstract butter from milk+ tách bơ ra khỏi sữa- lấy trộm ăn cắp- tóm tắt trích yếu@abstract- (tech) trừu tượng; tóm tắt trích yếu
abstractedly	riêng ra riêng ra
abstractedness	@abstractedness /æb''stræktidnis/* danh từ- sự lơ đãng
abstracter	@abstracter- xem abstract
abstracting	trích yếu luận án bài diễn văn...)- vật trừu tượng=in the abstract+ trừu tượng lý thuyết* ngoại động từ- trừu tượng hoá- làm đãng trí- rút ra chiết ra tách ra=to abstract butter from milk+ tách bơ ra khỏi sữa- lấy trộm ăn cắp- tóm tắt trích yếu@abstract- (tech) trừu tượng; tóm tắt trích yếu
abstraction	sự trừu tượng sự trừu tượng hoá- cách nhìn trừu tượng quan điểm trừu tượng; khái niệm trừu tượng; vật trừu tượng- sự lơ đãng- sự chiết ra sự rút ra- sự lấy trộm sự ăn cắp@abstraction- sự trừu tượng hoá sự trừu tượng
abstractionism	@abstractionism /æb''strækʃənizm/* danh từ- (nghệ thuật) chủ nghĩa trừu tượng
abstractionist	trừu tượng chủ nghĩa trừu tượng chủ nghĩa
abstractionists	trừu tượng chủ nghĩa trừu tượng chủ nghĩa
abstractions	sự trừu tượng sự trừu tượng hoá- cách nhìn trừu tượng quan điểm trừu tượng; khái niệm trừu tượng; vật trừu tượng- sự lơ đãng- sự chiết ra sự rút ra- sự lấy trộm sự ăn cắp@abstraction- sự trừu tượng hoá sự trừu tượng
abstractly	@abstractly- xem abstract
abstractness	@abstractness /''æbstræktnis/* danh từ- tính trừu tượng- tính khó hiểu
abstracts	trích yếu luận án bài diễn văn...)- vật trừu tượng=in the abstract+ trừu tượng lý thuyết* ngoại động từ- trừu tượng hoá- làm đãng trí- rút ra chiết ra tách ra=to abstract butter from milk+ tách bơ ra khỏi sữa- lấy trộm ăn cắp- tóm tắt trích yếu@abstract- (tech) trừu tượng; tóm tắt trích yếu
abstrahent	khó hiểu khó hiểu
abstriction	@abstriction* danh từ- (thực vật) sự tách rụng bào tử
abstruse	sâu sắc sâu sắc
abstrusely	sâu sắc sâu sắc
abstruseness	tính sâu sắc tính sâu sắc
absurd	phi lý ngớ ngẩn; buồn cười lố bịch@absurd- (tech) vô nghĩa phi lý@absurd- vô nghĩa vô lý phi lý
absurdities	phi lý sự ngớ ngẩn- điều vô lý; điều ngớ ngẩn@absurdity- [sự; tính] vô nghĩa vô lý phi lý
absurdity	phi lý sự ngớ ngẩn- điều vô lý; điều ngớ ngẩn@absurdity- [sự; tính] vô nghĩa vô lý phi lý
absurdly	lố bịch lố bịch
abterminal	@abterminal* tính từ- (thực vật) xa ngọn
abtruse	@abtruse* tính từ- khó hiểu
abulia	@abulia /ə''bauliə/ (abulia) /ə''bu:ljə/* danh từ- (y học) chứng mất ý chí
abulic	@abulic- xem abulia
abundance	sự dư dật=to live in abundance+ sống dư dật- sự dạt dào (tình cảm sự giàu có sự phong phú; sự thừa thãi sự dư dật=to live in abundance+ sống dư dật- sự dạt dào (tình cảm cảm xúc)=abundance of the heart+ sự dạt dào tình cảm- tình trạng rất đông người</q></n></i></f></c>');
abundant	dư dật=to be abundant in something+ có nhiều cái gì=an abundant year+ năm được mùa lớn@abundant- thừa nhiều chan chứa; thừa thãi dư dật=to be abundant in something+ có nhiều cái gì=an abundant year+ năm được mùa lớn@abundant- thừa
abundantly	@abundantly* phó từ- nhiều
abuse	hành hạ sự lộng hành=abuse of power+ sự lạm quyền=to remedy abuses+ sửa chữa thói lạm dụng- thói xấu hủ tục- sự lăng mạ sự sỉ nhục sự chửi rủa sự xỉ vả- sự nói xấu sự gièm pha- (từ mỹnghĩa mỹ) (từ cổnghĩa cổ) sự ngược đãi sự hành hạ=an abuse of animals+ sự hành hạ súc vật* ngoại động từ- lạm dụng (quyền hành...)- lăng mạ sỉ nhục chửi rủa- nói xấu gièm pha=to abuse somebody behind his bock+ nói xấu sau lưng ai- (từ cổnghĩa cổ) lừa dối lừa gạt- (từ mỹnghĩa mỹ) (từ cổnghĩa cổ) ngược đãi hành hạ
abused	hành hạ sự lộng hành=abuse of power+ sự lạm quyền=to remedy abuses+ sửa chữa thói lạm dụng- thói xấu hủ tục- sự lăng mạ sự sỉ nhục sự chửi rủa sự xỉ vả- sự nói xấu sự gièm pha- (từ mỹnghĩa mỹ) (từ cổnghĩa cổ) sự ngược đãi sự hành hạ=an abuse of animals+ sự hành hạ súc vật* ngoại động từ- lạm dụng (quyền hành...)- lăng mạ sỉ nhục chửi rủa- nói xấu gièm pha=to abuse somebody behind his bock+ nói xấu sau lưng ai- (từ cổnghĩa cổ) lừa dối lừa gạt- (từ mỹnghĩa mỹ) (từ cổnghĩa cổ) ngược đãi hành hạ
abuser	người lừa gạt người sỉ nhục người chửi rủa- người nói xấu kẻ gièm pha- người đánh lừa người lừa gạt
abusers	người lừa gạt người sỉ nhục người chửi rủa- người nói xấu kẻ gièm pha- người đánh lừa người lừa gạt
abuses	hành hạ sự lộng hành=abuse of power+ sự lạm quyền=to remedy abuses+ sửa chữa thói lạm dụng- thói xấu hủ tục- sự lăng mạ sự sỉ nhục sự chửi rủa sự xỉ vả- sự nói xấu sự gièm pha- (từ mỹnghĩa mỹ) (từ cổnghĩa cổ) sự ngược đãi sự hành hạ=an abuse of animals+ sự hành hạ súc vật* ngoại động từ- lạm dụng (quyền hành...)- lăng mạ sỉ nhục chửi rủa- nói xấu gièm pha=to abuse somebody behind his bock+ nói xấu sau lưng ai- (từ cổnghĩa cổ) lừa dối lừa gạt- (từ mỹnghĩa mỹ) (từ cổnghĩa cổ) ngược đãi hành hạ
abusing	hành hạ sự lộng hành=abuse of power+ sự lạm quyền=to remedy abuses+ sửa chữa thói lạm dụng- thói xấu hủ tục- sự lăng mạ sự sỉ nhục sự chửi rủa sự xỉ vả- sự nói xấu sự gièm pha- (từ mỹnghĩa mỹ) (từ cổnghĩa cổ) sự ngược đãi sự hành hạ=an abuse of animals+ sự hành hạ súc vật* ngoại động từ- lạm dụng (quyền hành...)- lăng mạ sỉ nhục chửi rủa- nói xấu gièm pha=to abuse somebody behind his bock+ nói xấu sau lưng ai- (từ cổnghĩa cổ) lừa dối lừa gạt- (từ mỹnghĩa mỹ) (từ cổnghĩa cổ) ngược đãi hành hạ
abusive	hành hạ sỉ nhục chửi rủa=abusive words+ những lời chưởi rủa những lời sỉ nhục- lừa dối lừa gạt- (từ mỹnghĩa mỹ) (từ cổnghĩa cổ) ngược đãi hành hạ
abusively	thoá mạ thoá mạ
abusiveness	sự hành hạ sự sỉ nhục sự chửi rủa thậm tệ- sự lừa dối sự lừa gạt- (từ mỹnghĩa mỹ) (từ cổnghĩa cổ) sự ngược đãi sự hành hạ
abut	nối đầu vào nhau@abut- kề sát; chung biên upon) giáp giới với tiếp giáp với- (+ on against) dựa vào nối đầu vào nhau@abut- kề sát; chung biên
abutilon	@abutilon /ə''bju:tilən/* danh từ- (thực vật học) giống cây cối xay
abutment	trụ chống; trụ đá (xây ở hai đầu cầu) biên giới chỗ tiếp giáp- tường chống trụ chống; trụ đá (xây ở hai đầu cầu)
abutments	trụ chống; trụ đá (xây ở hai đầu cầu) biên giới chỗ tiếp giáp- tường chống trụ chống; trụ đá (xây ở hai đầu cầu)
abuts	nối đầu vào nhau@abut- kề sát; chung biên upon) giáp giới với tiếp giáp với- (+ on against) dựa vào nối đầu vào nhau@abut- kề sát; chung biên
abuttal	chổ tiếp giáp biên giới chổ tiếp giáp
abuttals	chổ tiếp giáp biên giới chổ tiếp giáp
abutted	nối đầu vào nhau@abut- kề sát; chung biên upon) giáp giới với tiếp giáp với- (+ on against) dựa vào nối đầu vào nhau@abut- kề sát; chung biên
abutter	@abutter /ə''bʌtə/* danh từ- (pháp lý) chủ nhà đất láng giềng (ở ngay cạnh nhà đất của ai)
abutters	@abutter /ə''bʌtə/* danh từ- (pháp lý) chủ nhà đất láng giềng (ở ngay cạnh nhà đất của ai)
abutting	nối đầu vào nhau@abut- kề sát; chung biên tiếp giáp</q></n></i></f></c><c><f><i><n><q>@abut /ə''bʌt/* động từ- (+ on upon) giáp giới với tiếp giáp với- (+ on against) dựa vào nối đầu vào nhau@abut- kề sát; chung biên
abuzz	ồn ào ồn ào
abysm	@abysm /ə''bizm/* danh từ- (thơ ca) (như) abyss
abysmal	sâu không dò được=abysmal ignorance+ sự dốt nát cùng cực thăm thẳm sâu không dò được=abysmal ignorance+ sự dốt nát cùng cực
abysmally	vô cùng cùng cực vô cùng
abysms	@abysm /ə''bizm/* danh từ- (thơ ca) (như) abyss
abysopelagic	@abysopelagic* tính từ- thuộc vùng khơi- sâu thẳm
abyss	vực thẳm- biển thẳm- lòng trái đất; địa ngục vực thẳm- biển thẳm- lòng trái đất; địa ngục
abyssal	sâu không dò được=abyssal depth+ chỗ biển sâu nhất- (thuộc) biển thẳm=abyssal mund+ bùn biển thẳm sâu như vực thẳm sâu không dò được=abyssal depth+ chỗ biển sâu nhất- (thuộc) biển thẳm=abyssal mund+ bùn biển thẳm
abysses	vực thẳm- biển thẳm- lòng trái đất; địa ngục vực thẳm- biển thẳm- lòng trái đất; địa ngục
abyssobenthic	@abyssobenthic* tính từ- thuộc đáy biển thẳm; thuộc vực biển thẳm
ac	@ac/dc receiver- (tech) máy thu chạy điện xoay chiều-một chiều = universal receiver@ac/dc ringing- (tech) phép gọi điện xoay chiều-một chiều
ac (alternating component)	@ac (alternating component)- (tech) bộ phận xoay chiều
ac (alternating current)	dòng điện hai chiều; xoay chiều dòng điện hai chiều; xoay chiều
ac (alternating current) bus	@ac (alternating current) bus- (tech) mẫu tuyến dòng điện xoay chiều
ac (alternating current) charging	@ac (alternating current) charging- (tech) nạp điện dòng xoay chiều
ac (alternating current) circuit	@ac (alternating current) circuit- (tech) mạch điện xoay chiều
ac (alternating current) coupled flip-flop	@ac (alternating current) coupled flip-flop- (tech) mạch xúc phát ghép xoay chiều
ac (alternating current) coupling	@ac (alternating current) coupling- (tech) ghép xoay chiều
ac (alternating current) distribution cabinet	@ac (alternating current) distribution cabinet- (tech) hộp phân phối dòng điện xoay chiều
ac (alternating current) erasing	@ac (alternating current) erasing- (tech) xóa xoay chiều
ac (alternating current) erasing head	@ac (alternating current) erasing head- (tech) đầu xóa xoay chiều
ac (alternating current) generator	@ac (alternating current) generator- (tech) máy phát điện xoay chiều
ac (alternating current) josephson effect	@ac (alternating current) josephson effect- (tech) hiệu ứng josephson xoay chiều
ac (alternating current) motor	@ac (alternating current) motor- (tech) động cơ điện xoay chiều
ac (alternating current) oscillator	@ac (alternating current) oscillator- (tech) bộ dao động điện xoay chiều
ac (alternating current) oscillator source	@ac (alternating current) oscillator source- (tech) nguồn dao động điện xoay chiều
ac (alternating current) plate resistance	@ac (alternating current) plate resistance- (tech) điện trở bản cực xoay chiều
ac (alternating current) power supply	@ac (alternating current) power supply- (tech) nguồn điện xoay chiều
ac (alternating current) receiver	@ac (alternating current) receiver- (tech) máy thu chạy điện xoay chiều
ac (alternating current) resistance	@ac (alternating current) resistance- (tech) điện trở xoay chiều
ac (alternating current) servo motor	@ac (alternating current) servo motor- (tech) động cơ trợ động điện xoay chiều
ac-cut quartz	@ac-cut quartz- (tech) thạch anh kiểu cắt ac
acacia	@acacia /ə''keiʃə/* danh từ- (thực vật học) giống cây keo
acacias	@acacia /ə''keiʃə/* danh từ- (thực vật học) giống cây keo
academe	æk''ədi:m/* danh từ- (thơ ca) học viện; trường đại họcæk''ədi:m/* danh từ- (thơ ca) học viện; trường đại học
academese	@academese* danh từ- phong cách hàn lâm viện
academia	@academia* danh từ- giới học viện
academic	một vấn đề không thực tế- (văn nghệ) kinh viện=academic painting+ hội hoạ kinh viện- (thuộc) trường phái triết học pla-ton* danh từ- hội viên học viện- viện sĩ- người quá nệ kinh viện- (số nhiều) lập luận hoàn toàn lý thuyết- (số nhiều) mũ áo đại học (của giáo sư và học sinh đại học ở anh)ækə''demik/* tính từ- (thuộc) học viện; (thuộc) trường đại học- (thuộc) viện hàn lâm- có tính chất học thuật=an academic debate+ một cuộc tranh luận có tính chất học thuật- lý thuyết suông trừu tượng không thực tế=an academic question+ một vấn đề trừu tượng một vấn đề không thực tế- (văn nghệ) kinh viện=academic painting+ hội hoạ kinh viện- (thuộc) trường phái triết học pla-ton* danh từ- hội viên học viện- viện sĩ- người quá nệ kinh viện- (số nhiều) lập luận hoàn toàn lý thuyết- (số nhiều) mũ áo đại học (của giáo sư và học sinh đại học ở anh)
academical	ækə''demikəl/* tính từ- (thuộc) học viện; (thuộc) trường đại họcækə''demikəl/* tính từ- (thuộc) học viện; (thuộc) trường đại học
academically	thuần về lý thuyết thuần về lý thuyết
academicals	ækə''demikəlz/* danh từ số nhiều- mũ áo đại học (của giáo sư và học sinh đại học ở anh)ækə''demikəlz/* danh từ số nhiều- mũ áo đại học (của giáo sư và học sinh đại học ở anh)
academician	ækədə''miʃn/* danh từ- viện sĩækədə''miʃn/* danh từ- viện sĩ
academicians	ækədə''miʃn/* danh từ- viện sĩækədə''miʃn/* danh từ- viện sĩ
academics	một vấn đề không thực tế- (văn nghệ) kinh viện=academic painting+ hội hoạ kinh viện- (thuộc) trường phái triết học pla-ton* danh từ- hội viên học viện- viện sĩ- người quá nệ kinh viện- (số nhiều) lập luận hoàn toàn lý thuyết- (số nhiều) mũ áo đại học (của giáo sư và học sinh đại học ở anh)ækə''demik/* tính từ- (thuộc) học viện; (thuộc) trường đại học- (thuộc) viện hàn lâm- có tính chất học thuật=an academic debate+ một cuộc tranh luận có tính chất học thuật- lý thuyết suông trừu tượng không thực tế=an academic question+ một vấn đề trừu tượng một vấn đề không thực tế- (văn nghệ) kinh viện=academic painting+ hội hoạ kinh viện- (thuộc) trường phái triết học pla-ton* danh từ- hội viên học viện- viện sĩ- người quá nệ kinh viện- (số nhiều) lập luận hoàn toàn lý thuyết- (số nhiều) mũ áo đại học (của giáo sư và học sinh đại học ở anh)
academies	@academy /ə''kædəmi/* danh từ- học viện=a military academy+ học viện quân sự- viện hàn lâm- trường chuyên nghiệp- trường tư thục (dành cho trẻ em nhà giàu)- vườn a-ca-đê-mi (khu vườn gần a-ten nơi pla-ton giảng triết học); trường phái triết học pla-ton; môn đệ của pla-ton
academy	@academy /ə''kædəmi/* danh từ- học viện=a military academy+ học viện quân sự- viện hàn lâm- trường chuyên nghiệp- trường tư thục (dành cho trẻ em nhà giàu)- vườn a-ca-đê-mi (khu vườn gần a-ten nơi pla-ton giảng triết học); trường phái triết học pla-ton; môn đệ của pla-ton
academy award	@academy award* danh từ- phần thưởng hàng năm do hàn lâm viện điện ảnh - nghệ thuật - khoa học mỹ dành cho những thành tựu về điện ảnh
acaleph	@acaleph /''ækəlef/* danh từ- loài sứa
acanthi	acanthi- cây ô rô- (kiến trúc) hình trang trí lá ô rô số nhiều acanthuses acanthi- cây ô rô- (kiến trúc) hình trang trí lá ô rô</q></n></i></f></c><c><f><i><n><q>@acanthus /ə''kænθəs/* danh từ số nhiều acanthuses acanthi- cây ô rô- (kiến trúc) hình trang trí lá ô rô
acanthocarp	@acanthocarp* danh từ- quả gai
acanthocarpous	@acanthocarpous* tính từ- có quả gai
acanthocephalan	@acanthocephalan* danh từ- sâu bọ đầu gai* tính từ- thuộc sâu bọ đầu gai
acanthocephalans	@acanthocephalan* danh từ- sâu bọ đầu gai* tính từ- thuộc sâu bọ đầu gai
acanthocephalous	@acanthocephalous* tính từ- có đầu móc
acanthocladous	@acanthocladous* tính từ- có cành gai
acanthocyst	nang gai nang gai
acanthoma	@acanthoma* danh từ- bướu gai
acanthophore	@acanthophore* danh từ- cuống gai; gốc gai
acanthophysis	@acanthophysis* danh từ- sự rụng gai
acanthopore	@acanthopore* danh từ- (sinh học) sự hoá gai
acanthus	acanthi- cây ô rô- (kiến trúc) hình trang trí lá ô rô số nhiều acanthuses acanthi- cây ô rô- (kiến trúc) hình trang trí lá ô rô
acanthuses	acanthi- cây ô rô- (kiến trúc) hình trang trí lá ô rô số nhiều acanthuses acanthi- cây ô rô- (kiến trúc) hình trang trí lá ô rô
acapsular	không vỏ không vỏ
acardia	@acardia* danh từ- tật thiếu tim (bẩm sinh)
acari	số nhiều acari- (động vật học) cái ghẻ số nhiều acari- (động vật học) cái ghẻ</q></n></i></f></c><c><f><i><n><q>@acarus /''ækərəs/* danh từ số nhiều acari- (động vật học) cái ghẻ
acarid	@acarid* danh từ- (động vật) bộ ve bét* tính từ- thuộc bộ ve bét
acarids	@acarid* danh từ- (động vật) bộ ve bét* tính từ- thuộc bộ ve bét
acarpellous	ækɑ:''peləs/* tính từ- (thực vật học) không lá noãnækɑ:''peləs/* tính từ- (thực vật học) không lá noãn
acarpous	@acarpous /ə''kɑ:pəs/* tính từ- (thực vật học) không sinh quả
acarus	số nhiều acari- (động vật học) cái ghẻ số nhiều acari- (động vật học) cái ghẻ
acas	conciliation and arbitration service) hoà giải và cố vấn (advisory conciliation and arbitration service)
acatalectic	@acatalectic* danh từ- câu có số âm tiết đầy đủ (câu thơ)
acaulescent	@acaulescent* tính từ- (thực vật) không thân cây
acaulesent	@acaulesent /ə''kɔ:ləs/* tính từ- (thực vật học) không thân (cây)
acauline	@acauline /ə''kɔ:ləs/* tính từ- (thực vật học) không thân (cây)
acaulose	@acaulose /ə''kɔ:ləs/* tính từ- (thực vật học) không thân (cây)
acaulosia	@acaulosia* danh từ- sự không phát triển thân
acaulous	@acaulous /ə''kɔ:ləs/* tính từ- (thực vật học) không thân (cây)
accede	tham gia=to acceden to a party+ gia nhập một đảng phái=to accede to a treaty+ tham gia một hiệp ước (bằng cách chính thức tuyên bố chấp thuận) tán thành thừa nhận bằng lòng=to accede to an apinion+ đồng ý với một ý kiến=to accede to a policy+ tán thành một chính sách- lên (ngôi) nhậm (chức)=to accede to the throne+ lên ngôi=to accede to an office+ nhậm chức- gia nhập tham gia=to acceden to a party+ gia nhập một đảng phái=to accede to a treaty+ tham gia một hiệp ước (bằng cách chính thức tuyên bố chấp thuận)
acceded	tham gia=to acceden to a party+ gia nhập một đảng phái=to accede to a treaty+ tham gia một hiệp ước (bằng cách chính thức tuyên bố chấp thuận) tán thành thừa nhận bằng lòng=to accede to an apinion+ đồng ý với một ý kiến=to accede to a policy+ tán thành một chính sách- lên (ngôi) nhậm (chức)=to accede to the throne+ lên ngôi=to accede to an office+ nhậm chức- gia nhập tham gia=to acceden to a party+ gia nhập một đảng phái=to accede to a treaty+ tham gia một hiệp ước (bằng cách chính thức tuyên bố chấp thuận)
accedence	@accedence- xem accede
acceder	@acceder- xem accede
accedes	tham gia=to acceden to a party+ gia nhập một đảng phái=to accede to a treaty+ tham gia một hiệp ước (bằng cách chính thức tuyên bố chấp thuận) tán thành thừa nhận bằng lòng=to accede to an apinion+ đồng ý với một ý kiến=to accede to a policy+ tán thành một chính sách- lên (ngôi) nhậm (chức)=to accede to the throne+ lên ngôi=to accede to an office+ nhậm chức- gia nhập tham gia=to acceden to a party+ gia nhập một đảng phái=to accede to a treaty+ tham gia một hiệp ước (bằng cách chính thức tuyên bố chấp thuận)
acceding	tham gia=to acceden to a party+ gia nhập một đảng phái=to accede to a treaty+ tham gia một hiệp ước (bằng cách chính thức tuyên bố chấp thuận) tán thành thừa nhận bằng lòng=to accede to an apinion+ đồng ý với một ý kiến=to accede to a policy+ tán thành một chính sách- lên (ngôi) nhậm (chức)=to accede to the throne+ lên ngôi=to accede to an office+ nhậm chức- gia nhập tham gia=to acceden to a party+ gia nhập một đảng phái=to accede to a treaty+ tham gia một hiệp ước (bằng cách chính thức tuyên bố chấp thuận)
accelerando	adv- (nhạc) nhanh dần* danh từ- bản nhạc chơi nhanh dầnadv- (nhạc) nhanh dần* danh từ- bản nhạc chơi nhanh dần
accelerandou	adv- (âm nhạc) nhanh lên adv- (âm nhạc) nhanh lên
accelerant	@accelerant* danh từ- (hoá học) chất làm phản ứng hoá học xuất hiện nhanh hơn
accelerants	@accelerant* danh từ- (hoá học) chất làm phản ứng hoá học xuất hiện nhanh hơn
accelerate	làm nhanh giục gấp- rảo (bước)=to accelerate the pace+ bước mau hơn rảo bước* nội động từ- tăng nhanh hơn; mau hơn bước mau hơn rảo bước- gia tốc@accelerate- tăng tốc gia tốc làm nhanh
accelerated	làm nhanh giục gấp- rảo (bước)=to accelerate the pace+ bước mau hơn rảo bước* nội động từ- tăng nhanh hơn; mau hơn bước mau hơn rảo bước- gia tốc@accelerate- tăng tốc gia tốc làm nhanh
accelerated depreciation	khấu hao gia tốc.+ xem depreciation khấu hao gia tốc.+ xem depreciation
accelerated test	@accelerated test- (tech) trắc nghiệm gia tốc
accelerates	làm nhanh giục gấp- rảo (bước)=to accelerate the pace+ bước mau hơn rảo bước* nội động từ- tăng nhanh hơn; mau hơn bước mau hơn rảo bước- gia tốc@accelerate- tăng tốc gia tốc làm nhanh
accelerating	làm nhanh giục gấp- rảo (bước)=to accelerate the pace+ bước mau hơn rảo bước* nội động từ- tăng nhanh hơn; mau hơn bước mau hơn rảo bước- gia tốc@accelerate- tăng tốc gia tốc làm nhanh
accelerating anode	@accelerating anode- (tech) dương cực gia tốc
accelerating cavity	@accelerating cavity- (tech) cái hốc gia tốc
accelerating coil	@accelerating coil- (tech) cuộn dây gia tốc
accelerating electrode	@accelerating electrode- (tech) điện cực gia tốc
accelerating field	@accelerating field- (tech) trường gia tốc
accelerating grid	@accelerating grid- (tech) lưới gia tốc
accelerating inflation	@accelerating inflation- (econ) lạm phát gia tốc.+ sự tăng vọt tỷ lệ lạm phát. nếu chính phủ cố giữ tỷ lệ thất nghiệp dưới mức tỷ lệ thất nghiệp tự nhiên thì việc đó sẽ dẫn tới lạm phát gia tốc.
accelerating potential	@accelerating potential- (tech) thế gia tốc
acceleration	gia tốc coriolit- instantaneous a. gia tốc tức thời- local a. gia tốc địa phương- normal a. gia tốc pháp tuyến- relative a. gia tốc tương đối- standar gravitationnal a. gia tốc trọng trường tiêu chuẩn- supplemental a. gia tốc tiếp tuyến- total a. gia tốc toàn phần- uniform a.gia tốc đều sự thúc mau sự giục gấp- gia tốc=acceleration of gravity+ (vật lý) gia tốc của trọng lực@acceleration- (tech) gia tốc tăng tốc; độ gia tốc@acceleration- sự tăng tốc sự gia tốc sự làm nhanh- a. by powering sự tăng nhanh độ hội tụ bằng cách nâng lên luỹ thừa - a. of convergence sự tăng nhanh độ hội tụ gia tốc hội tụ- a. of corriolis sự tăng tốc coriolit- a. of gravity gia tốc trọng trường- a. of falliing body sự tăng tốc gia tốc vật rơi- a. of translation gia tốc tịnh tiến- angular a. gia tốc góc- average a. gia tốc trung bình- centripetal a. gia tốc hướng tâm@acceleration- complementary a. sự tăng tốc coriolit gia tốc coriolit- instantaneous a. gia tốc tức thời- local a. gia tốc địa phương- normal a. gia tốc pháp tuyến- relative a. gia tốc tương đối- standar gravitationnal a. gia tốc trọng trường tiêu chuẩn- supplemental a. gia tốc tiếp tuyến- total a. gia tốc toàn phần- uniform a.gia tốc đều
acceleration of convergence	@acceleration of convergence- (tech) gia tốc hội tụ
acceleration parameter	@acceleration parameter- (tech) thông số gia tốc
acceleration voltage	@acceleration voltage- (tech) điện thế gia tốc
accelerations	gia tốc coriolit- instantaneous a. gia tốc tức thời- local a. gia tốc địa phương- normal a. gia tốc pháp tuyến- relative a. gia tốc tương đối- standar gravitationnal a. gia tốc trọng trường tiêu chuẩn- supplemental a. gia tốc tiếp tuyến- total a. gia tốc toàn phần- uniform a.gia tốc đều sự thúc mau sự giục gấp- gia tốc=acceleration of gravity+ (vật lý) gia tốc của trọng lực@acceleration- (tech) gia tốc tăng tốc; độ gia tốc@acceleration- sự tăng tốc sự gia tốc sự làm nhanh- a. by powering sự tăng nhanh độ hội tụ bằng cách nâng lên luỹ thừa - a. of convergence sự tăng nhanh độ hội tụ gia tốc hội tụ- a. of corriolis sự tăng tốc coriolit- a. of gravity gia tốc trọng trường- a. of falliing body sự tăng tốc gia tốc vật rơi- a. of translation gia tốc tịnh tiến- angular a. gia tốc góc- average a. gia tốc trung bình- centripetal a. gia tốc hướng tâm@acceleration- complementary a. sự tăng tốc coriolit gia tốc coriolit- instantaneous a. gia tốc tức thời- local a. gia tốc địa phương- normal a. gia tốc pháp tuyến- relative a. gia tốc tương đối- standar gravitationnal a. gia tốc trọng trường tiêu chuẩn- supplemental a. gia tốc tiếp tuyến- total a. gia tốc toàn phần- uniform a.gia tốc đều
accelerative	làm mau thêm làm mau thêm
accelerator	@accelerator- (econ) gia số+ xem accelerator principle.
accelerator board	tấm gia tốc tấm gia tốc
accelerator card	@accelerator card- (tech) thẻ gia tốc
accelerator coefficient	@accelerator coefficient- (econ) hệ số gia tốc.+ một bội số theo đó đầu tư mới sẽ tăng lên khi có sự thay đổi về sản lượng.
accelerator effect	@accelerator effect- (econ) hiệu ứng gia tốc.
accelerator key	phím gia tốc = hot key phím gia tốc = hot key
accelerator principle	@accelerator principle- (econ) nguyên lý gia tốc.+ nguyên lý cho rằng mức đầu tư ròng phụ thuộc vào mức thay đổi dự kiến về sản lượng.
accelerators	bộ tăng tốc bộ tăng tốc
accelerometer	gia tốc kế gia tốc kế
accelerometers	gia tốc kế gia tốc kế
accent	âm phù; giọng nhấn; đánh dấu (đ); nhấn mạnh (đ)@accent- dấu phẩy lời lẽ=he found every moving accent to persuade his audience+ anh tìm những lời lẽ thật cảm động để thuyết phục thính giả- (âm nhạc) nhấn; dấu nhấn- (nghĩa bóng) sự phân biệt rõ rệt* ngoại động từ- đọc có trọng âm nói có trọng âm đọc nhấn mạnh- đánh dấu trọng âm- nhấn mạnh nêu bật@accent- (tech) dấu âm phù; giọng nhấn; đánh dấu (đ); nhấn mạnh (đ)@accent- dấu phẩy
accented	âm phù; giọng nhấn; đánh dấu (đ); nhấn mạnh (đ)@accent- dấu phẩy lời lẽ=he found every moving accent to persuade his audience+ anh tìm những lời lẽ thật cảm động để thuyết phục thính giả- (âm nhạc) nhấn; dấu nhấn- (nghĩa bóng) sự phân biệt rõ rệt* ngoại động từ- đọc có trọng âm nói có trọng âm đọc nhấn mạnh- đánh dấu trọng âm- nhấn mạnh nêu bật@accent- (tech) dấu âm phù; giọng nhấn; đánh dấu (đ); nhấn mạnh (đ)@accent- dấu phẩy
accented character	@accented character- (tech) chữ có dấu
accenting	âm phù; giọng nhấn; đánh dấu (đ); nhấn mạnh (đ)@accent- dấu phẩy lời lẽ=he found every moving accent to persuade his audience+ anh tìm những lời lẽ thật cảm động để thuyết phục thính giả- (âm nhạc) nhấn; dấu nhấn- (nghĩa bóng) sự phân biệt rõ rệt* ngoại động từ- đọc có trọng âm nói có trọng âm đọc nhấn mạnh- đánh dấu trọng âm- nhấn mạnh nêu bật@accent- (tech) dấu âm phù; giọng nhấn; đánh dấu (đ); nhấn mạnh (đ)@accent- dấu phẩy
accentor	@accentor /æk''sentə/* danh từ- (động vật học) chim chích
accents	âm phù; giọng nhấn; đánh dấu (đ); nhấn mạnh (đ)@accent- dấu phẩy lời lẽ=he found every moving accent to persuade his audience+ anh tìm những lời lẽ thật cảm động để thuyết phục thính giả- (âm nhạc) nhấn; dấu nhấn- (nghĩa bóng) sự phân biệt rõ rệt* ngoại động từ- đọc có trọng âm nói có trọng âm đọc nhấn mạnh- đánh dấu trọng âm- nhấn mạnh nêu bật@accent- (tech) dấu âm phù; giọng nhấn; đánh dấu (đ); nhấn mạnh (đ)@accent- dấu phẩy
accentual	@accentual /æk''sentjuəl/* tính từ- (thuộc) trọng âm; dựa vào trọng âm
accentually	@accentually- xem accentual
accentuate	nêu bật đặt trọng âm đánh dấu trọng âm- nhấn mạnh làm nổi bật nêu bật
accentuated	nêu bật đặt trọng âm đánh dấu trọng âm- nhấn mạnh làm nổi bật nêu bật
accentuated contrast	@accentuated contrast- (tech) sự tương phản tăng cường
accentuates	nêu bật đặt trọng âm đánh dấu trọng âm- nhấn mạnh làm nổi bật nêu bật
accentuating	nêu bật đặt trọng âm đánh dấu trọng âm- nhấn mạnh làm nổi bật nêu bật
accentuation	nhấn mạnh sự đặt trọng âm sự đánh dấu trọng âm- sự nhấn mạnh sự nêu bật@accentuation- (tech) gia cường nhấn mạnh
accentuations	nhấn mạnh sự đặt trọng âm sự đánh dấu trọng âm- sự nhấn mạnh sự nêu bật@accentuation- (tech) gia cường nhấn mạnh
accentuator	bộ tăng sóng bộ tăng sóng
accentuators	bộ tăng sóng bộ tăng sóng
accept	chấp nhận; thừa nhận; không bác bỏ chấp nhận chấp thuận=to accept a proposal+ chấp nhận một đề nghị=to accept a present+ nhận một món quà=to accept an invitation+ nhận lời mời- thừa nhận=to accept a truth+ thừa nhận một sự thật- đảm nhận (công việc...)- (thương nghiệp) chịu trách nhiệm về; nhận thanh toán (hoá đơn hối phiếu...)@accept- nhận chấp nhận; thừa nhận; không bác bỏ
accept connection	@accept connection- (tech) nối nhận
accept stacker	@accept stacker- (tech) hộp chứa phiếu đã đọc
accept statement	@accept statement- (tech) câu lệnh nhận
acceptabilities	septə''biliti/* danh từ- tính chất có thể chấp nhận- tính chất có thể thừa nhậnseptə''biliti/* danh từ- tính chất có thể chấp nhận- tính chất có thể thừa nhận
acceptability	septə''biliti/* danh từ- tính chất có thể chấp nhận- tính chất có thể thừa nhậnseptə''biliti/* danh từ- tính chất có thể chấp nhận- tính chất có thể thừa nhận
acceptable	thừa nhận được có thể chấp nhận- có thể thừa nhận- thoả đáng làm hài lòng; được hoan nghênh được tán thưởng@acceptable- nhận được chấp nhận được thừa nhận được
acceptable quality level (aql)	@acceptable quality level (aql)- (tech) mức độ phẩm chất chấp nhận được
acceptableness	@acceptableness- xem acceptable
acceptably	đáng tán thưởng thừa nhận được- đáng hoan nghênh đáng tán thưởng
acceptance	bao gồm ký hối phiếu và thường ký trên mặt hối phiếu. bao gồm ký hối phiếu và thường ký trên mặt hối phiếu.
acceptance angle	góc nhận ánh sáng góc nhận ánh sáng
acceptance cone	@acceptance cone- (tech) chóp thụ quang
acceptance inspection	@acceptance inspection- (tech) kiểm tra nghiệm thu
acceptance pattern	@acceptance pattern- (tech) mô thức thụ quang
acceptance test	trắc nghiệm kiểm nhận trắc nghiệm kiểm nhận
acceptance trials	@acceptance trials- (tech) thực nghiệm thụ quang
acceptances	sự thu nhận bao gồm ký hối phiếu và thường ký trên mặt hối phiếu.</q></n></i></f></c><c><f><i><n><q>@acceptance /ək''septəbl/* danh từ- sự nhận sự chấp nhận sự chấp thuận- sự thừa nhận sự công nhận- sự hoan nghênh sự tán thưởng sự tán thành; sự tin=his statement will not find acceptance+ lời tuyên bố của ông ta sẽ không được ai tin- (thương nghiệp) sự nhận thanh toán (hoá đơn); hoá đơn được nhận thanh toán=general acceptance+ sự nhận thanh toán không cần có điều kiện=qualified acceptance+ sự nhận thanh toán có điều kiện!acceptance of persons- sự thiên vị@acceptance- sự nhận sự thu nhận
acceptation	thành ngữ)æksep''teiʃn/* danh từ- ý nghĩa đặc biệt (của một từ thành ngữ)- nghĩa được thừa nhận (của một từ thành ngữ)
accepted	chấp nhận; thừa nhận; không bác bỏ đã được công nhận@accepted- được công nhận được thừa nhận</q></n></i></f></c><c><f><i><n><q>@accept /ək''sept/* ngoại động từ- nhận chấp nhận chấp thuận=to accept a proposal+ chấp nhận một đề nghị=to accept a present+ nhận một món quà=to accept an invitation+ nhận lời mời- thừa nhận=to accept a truth+ thừa nhận một sự thật- đảm nhận (công việc...)- (thương nghiệp) chịu trách nhiệm về; nhận thanh toán (hoá đơn hối phiếu...)@accept- nhận chấp nhận; thừa nhận; không bác bỏ
accepting	chấp nhận; thừa nhận; không bác bỏ chấp nhận chấp thuận=to accept a proposal+ chấp nhận một đề nghị=to accept a present+ nhận một món quà=to accept an invitation+ nhận lời mời- thừa nhận=to accept a truth+ thừa nhận một sự thật- đảm nhận (công việc...)- (thương nghiệp) chịu trách nhiệm về; nhận thanh toán (hoá đơn hối phiếu...)@accept- nhận chấp nhận; thừa nhận; không bác bỏ
accepting house	nghĩa là chấp nhận thanh toán chúng khi đáo hạn. với mục đích thu tiền hoa hồng ngân hàng này nhận trả các hối phiếu nghĩa là chấp nhận thanh toán chúng khi đáo hạn.
accepting station	@accepting station- (tech) trạm nhận tin
acceptor	mạch nhận; chất tạp nhận phần tử nhận; mạch cộng hưởng (nối tiếp) mạch nhận; chất tạp nhận
acceptor center	@acceptor center- (tech) trung tâm tiếp nhận
acceptor circuit	mạch nhận mạch nhận
acceptor level	@acceptor level- (tech) mức nhận
acceptor state	@acceptor state- (tech) trạng thái nhận
acceptor type trap	@acceptor type trap- (tech) cái bẫy loại nhận
acceptors	phần tử nhận; mạch cộng hưởng (nối tiếp) phần tử nhận; mạch cộng hưởng (nối tiếp) mạch nhận; chất tạp nhận</q></n></i></f></c>');
accesion rate	@accesion rate- (econ) tỷ lệ gia tăng lao động.+ số lượng những người thuê mới mỗi tháng tính theo tỷ lệ phần trăm tổng số việc làm do bộ lao động mỹ thống kê.
accesions tax	@accesions tax- (econ) thuế quà tặng.+ thuế đánh vào quà tặng và tài sản thừa kế.
accesory	@accesory- phụ thêm; phụ tùng
access	giải thích các hình thái vị trí do đánh đổi giữa khả năng tiếp cận của một địa điểm tới trung tâm của vùng và không gian của địa điểm đó. giải thích các hình thái vị trí do đánh đổi giữa khả năng tiếp cận của một địa điểm tới trung tâm của vùng và không gian của địa điểm đó.
access address	@access address- (tech) địa chỉ truy cập
access arm	@access arm- &lt;tin&gt; cần mang đầu từ
access attempt	@access attempt- (tech) lần thử độ truy cập
access barred signal	@access barred signal- (tech) tín hiệu cản truy cập
access category	@access category- (tech) hạng mục/loại truy cập
access code	@access code- (tech) mã truy cập
access control	@access control- (tech) điều khiển truy cập
access control device (acd)	@access control device (acd)- (tech) thiết bị điều khiển truy cập
access coupler	@access coupler- (tech) bộ ghép truy cập
access denial	@access denial- (tech) chối bỏ/từ khước truy cập
access digit	@access digit- (tech) số mã truy cập
access failure	@access failure- (tech) thất bại truy cập
access hierarchy	@access hierarchy- (tech) giai tầng truy cập [nb]
access hole	@access hole- &lt;tin&gt; khe đầu từ
access key	@access key- (tech) phím truy cập
access level	@access level- (tech) mức truy cập
access list	@access list- (tech) danh sách truy cập
access memory	@access memory- (tech) bộ nhớ truy cập
access menu	@access menu- (tech) đơn chọn truy cập
access method	@access method- (tech) phương pháp truy cập
access mode	@access mode- (tech) kiểu truy cập
access model	@access model- (tech) mô hình truy cập
access originator	@access originator- (tech) nguồn khởi truy cập
access path	@access path- (tech) đường truy cập
access period	@access period- (tech) thời kỳ truy cập
access permission	@access permission- (tech) cho phép truy cập
access phase	@access phase- (tech) pha/vị tướng truy cập
access plan	@access plan- (tech) kế hoạch truy cập
access point	@access point- (tech) điểm truy cập
access port	@access port- (tech) bến truy cập
access privilege	@access privilege- (tech) đặc quyền truy cập [nb]
access procedure	@access procedure- (tech) thủ tục truy cập
access protocol	@access protocol- (tech) nghi thức truy cập
access rate = access speed	@access rate = access speed- (tech) tốc độ truy cập
access request	@access request- (tech) yêu cầu truy cập
access success	@access success- (tech) thành công truy cập
access success ratio	@access success ratio- (tech) tỉ lệ thành công truy cập
access time	@access time- (tech) thời gian truy cập; thời gian thiết lập
access type	@access type- (tech) loại truy cập
access-denial probability	@access-denial probability- (tech) xác suất từ khước truy cập
access-denial time	@access-denial time- (tech) thời gian từ khước truy cập
access-rights terminal	@access-rights terminal- (tech) đầu cuối dành quyền truy cập
accessaries	đồng loã (thường) số nhiều- đồ phụ tùng; vật phụ thuộc; đồ thêm vào- (pháp lý) kẻ tòng phạm kẻ a tòng kẻ đồng loã* tính từ- phụ phụ vào thêm vào- (pháp lý) a tòng đồng loã
accessary	đồng loã (thường) số nhiều- đồ phụ tùng; vật phụ thuộc; đồ thêm vào- (pháp lý) kẻ tòng phạm kẻ a tòng kẻ đồng loã* tính từ- phụ phụ vào thêm vào- (pháp lý) a tòng đồng loã
accessed	tồn thủ; tìm vào@access- sự cho vào; (máy tính) lối vào nhận tin- random a. thứ tự chọn ngẫu nhiên giải thích các hình thái vị trí do đánh đổi giữa khả năng tiếp cận của một địa điểm tới trung tâm của vùng và không gian của địa điểm đó.</q></n></i></f></c><c><f><i><n><q>@access /''ækses/* danh từ- lối vào cửa vào đường vào- sự đến gần sự cho vào sự lui tới; quyền đến gần quyền lui tới=easy of access+ dễ đến gần dễ lui tới=difficult of access+ khó đến gần khó lui tới=to have access to somebody+ được gần gũi ai được lui tới nhà ai- sự dâng lên (nước triều)=the access and recess of the sea+ lúc triều lên và triều xuống ở biển- cơn=access of anger+ cơn giận=access of illness+ cơn bệnh- sự thêm vào sự tăng lên=access of wealth+ sự giàu có thêm lên@access- (tech) truy cập truy tìm truy xuất-nhập tồn thủ [tq]; lối vào; tiếp cận; viết (vào)-đọc (ra) tồn thủ; tìm vào@access- sự cho vào; (máy tính) lối vào nhận tin- random a. thứ tự chọn ngẫu nhiên
accesses	tồn thủ; tìm vào@access- sự cho vào; (máy tính) lối vào nhận tin- random a. thứ tự chọn ngẫu nhiên giải thích các hình thái vị trí do đánh đổi giữa khả năng tiếp cận của một địa điểm tới trung tâm của vùng và không gian của địa điểm đó.</q></n></i></f></c><c><f><i><n><q>@access /''ækses/* danh từ- lối vào cửa vào đường vào- sự đến gần sự cho vào sự lui tới; quyền đến gần quyền lui tới=easy of access+ dễ đến gần dễ lui tới=difficult of access+ khó đến gần khó lui tới=to have access to somebody+ được gần gũi ai được lui tới nhà ai- sự dâng lên (nước triều)=the access and recess of the sea+ lúc triều lên và triều xuống ở biển- cơn=access of anger+ cơn giận=access of illness+ cơn bệnh- sự thêm vào sự tăng lên=access of wealth+ sự giàu có thêm lên@access- (tech) truy cập truy tìm truy xuất-nhập tồn thủ [tq]; lối vào; tiếp cận; viết (vào)-đọc (ra) tồn thủ; tìm vào@access- sự cho vào; (máy tính) lối vào nhận tin- random a. thứ tự chọn ngẫu nhiên
accessibilities	tính có thể đến gần được- sự dễ bị ảnh hưởng@accessibility- (tech) khả năng truy cập; tính tiếp cậnsesi''biliti/* danh từ- tính có thể tới được tính có thể đến gần được- sự dễ bị ảnh hưởng@accessibility- (tech) khả năng truy cập; tính tiếp cận
accessibility	tính có thể đến gần được- sự dễ bị ảnh hưởng@accessibility- (tech) khả năng truy cập; tính tiếp cậnsesi''biliti/* danh từ- tính có thể tới được tính có thể đến gần được- sự dễ bị ảnh hưởng@accessibility- (tech) khả năng truy cập; tính tiếp cận
accessible	đạt được có thể gần được=the remote hamlet is accessible by bicycle+ cái xóm nghèo hẻo lánh đó có thể đi xe đạp đến được- dễ bị ảnh hưởng=accessible to bribery+ dễ hối lộ dễ đút lót- dễ gần (người)@accessible- tới được đạt được
accessibleness	@accessibleness- xem accessible
accessibly	@accessibly- xem accessible
accessiflexor	@accessiflexor* danh từ- (giải phẫu) cơ gấp phụ
accessing	tồn thủ; tìm vào@access- sự cho vào; (máy tính) lối vào nhận tin- random a. thứ tự chọn ngẫu nhiên giải thích các hình thái vị trí do đánh đổi giữa khả năng tiếp cận của một địa điểm tới trung tâm của vùng và không gian của địa điểm đó.</q></n></i></f></c><c><f><i><n><q>@access /''ækses/* danh từ- lối vào cửa vào đường vào- sự đến gần sự cho vào sự lui tới; quyền đến gần quyền lui tới=easy of access+ dễ đến gần dễ lui tới=difficult of access+ khó đến gần khó lui tới=to have access to somebody+ được gần gũi ai được lui tới nhà ai- sự dâng lên (nước triều)=the access and recess of the sea+ lúc triều lên và triều xuống ở biển- cơn=access of anger+ cơn giận=access of illness+ cơn bệnh- sự thêm vào sự tăng lên=access of wealth+ sự giàu có thêm lên@access- (tech) truy cập truy tìm truy xuất-nhập tồn thủ [tq]; lối vào; tiếp cận; viết (vào)-đọc (ra) tồn thủ; tìm vào@access- sự cho vào; (máy tính) lối vào nhận tin- random a. thứ tự chọn ngẫu nhiên
accession	sự tham gia=accession to an international treaty+ sự tham gia một hiệp ước quốc tế- sự tán thành sự tiếp kiến- sự lên ngôi sự nhậm chức; sự đến sự đạt tới=accession to the throne+ sự lên ngôi=accession to office+ sự nhậm chức=accession to manhood+ sự đến tuổi trưởng thành- sự tăng thêm sự thêm vào; phần thêm vào=an accession to one''s stock of knowledge+ sự góp thêm vào cái vốn hiểu biết- sự gia nhập sự tham gia=accession to an international treaty+ sự tham gia một hiệp ước quốc tế- sự tán thành
accessional	@accessional- xem accession
accessions	sự tham gia=accession to an international treaty+ sự tham gia một hiệp ước quốc tế- sự tán thành sự tiếp kiến- sự lên ngôi sự nhậm chức; sự đến sự đạt tới=accession to the throne+ sự lên ngôi=accession to office+ sự nhậm chức=accession to manhood+ sự đến tuổi trưởng thành- sự tăng thêm sự thêm vào; phần thêm vào=an accession to one''s stock of knowledge+ sự góp thêm vào cái vốn hiểu biết- sự gia nhập sự tham gia=accession to an international treaty+ sự tham gia một hiệp ước quốc tế- sự tán thành
accessorial	@accessorial- xem accessory
accessories	đồng loã bộ phụ phụ kiện [tq]</q></n></i></f></c><c><f><i><n><q>@accessory /æk''sesəri/ (accessary) /æk''sesəri/* danh từ (thường) số nhiều- đồ phụ tùng; vật phụ thuộc; đồ thêm vào- (pháp lý) kẻ tòng phạm kẻ a tòng kẻ đồng loã* tính từ- phụ phụ vào thêm vào- (pháp lý) a tòng đồng loã
accessorii	@accessorius* danh từ- (giải phẫu) cơ phụ; dây thần kinh não x
accessorily	@accessorily- xem accessory
accessoriness	@accessoriness- xem accessory
accessorius	@accessorius* danh từ- (giải phẫu) cơ phụ; dây thần kinh não x
accessory	đồng loã (thường) số nhiều- đồ phụ tùng; vật phụ thuộc; đồ thêm vào- (pháp lý) kẻ tòng phạm kẻ a tòng kẻ đồng loã* tính từ- phụ phụ vào thêm vào- (pháp lý) a tòng đồng loã
accessory software	@accessory software- (tech) nhu liệu/phần mềm phụ
acciaccatura	@acciaccatura* danh từ (âm nhạc)- nốt dựa
acciaccature	@acciaccatura* danh từ (âm nhạc)- nốt dựa
accidence	@accidence /''æksidəns/* danh từ- (ngôn ngữ học) hình thái học- yếu tố cơ sở (của một vấn đề)
accident	trường hợp không may tai nạn tai biến=without accident+ an toàn không xảy ra tai nạn=to meet with an accident+ gặp rủi ro; gặp tai nạn gặp tai biến- sự tình cờ sự ngẫu nhiên=by accident+ tình cờ ngẫu nhiên- cái phụ cái không chủ yếu- sự gồ ghề sự khấp khểnh- (âm nhạc) dấu thăng giáng bất thường@accident- (tech) hư hỏng tai nạn@accident- sự ngẫu nhiên trường hợp không may
accident-prone	@accident-prone* tính từ- thường xảy ra tai nạn
accidental	cái không chủ yếu- (âm nhạc) dấu thăng giáng bất thường@accidental- (tech) rũi ro; phụ@accidental- ngẫu nhiênæksi''dentl/* tính từ- tình cờ ngẫu nhiên; bất ngờ- phụ phụ thuộc không chủ yếu* danh từ- cái phụ cái không chủ yếu- (âm nhạc) dấu thăng giáng bất thường@accidental- (tech) rũi ro; phụ@accidental- ngẫu nhiên
accidental error	@accidental error- (tech) sai số rủi ro
accidentally	ngẫu nhiênæksi''dentəli/* phó từ- tình cờ ngẫu nhiên
accidents	trường hợp không may tai nạn tai biến=without accident+ an toàn không xảy ra tai nạn=to meet with an accident+ gặp rủi ro; gặp tai nạn gặp tai biến- sự tình cờ sự ngẫu nhiên=by accident+ tình cờ ngẫu nhiên- cái phụ cái không chủ yếu- sự gồ ghề sự khấp khểnh- (âm nhạc) dấu thăng giáng bất thường@accident- (tech) hư hỏng tai nạn@accident- sự ngẫu nhiên trường hợp không may
accipiter	@accipiter* danh từ- chim ưng
accipiters	@accipiter* danh từ- chim ưng
accipitral	@accipitral /æk''sipitrəl/* tính từ- (thuộc) chim ưng; như chim ưng- tham mồi (như chim ưng); tham tàn- tinh mắt (như chim ưng)
accipitrine	@accipitrine* tính từ- liên quan tới chim ưng; giống như chim ưng
acclaim	@acclaim /ə''kleim/* danh từ- tiếng hoan hô* ngoại động từ- hoan hô- tôn lên=to be acclaimed king+ được tôn lên làm vua
acclaimed	@acclaim /ə''kleim/* danh từ- tiếng hoan hô* ngoại động từ- hoan hô- tôn lên=to be acclaimed king+ được tôn lên làm vua
acclaimer	@acclaimer- xem acclaim
acclaiming	@acclaim /ə''kleim/* danh từ- tiếng hoan hô* ngoại động từ- hoan hô- tôn lên=to be acclaimed king+ được tôn lên làm vua
acclaims	@acclaim /ə''kleim/* danh từ- tiếng hoan hô* ngoại động từ- hoan hô- tôn lên=to be acclaimed king+ được tôn lên làm vua
acclamation	tiếng tung hôæklə''meiʃn/* danh từ- sự hoan hô nhiệt liệt=carried by acclamation+ thông qua bằng cách hoan hô=the decision was carried by acclamation+ mọi người vỗ tay hoan hô thông qua nghị quyết- ((thường) số nhiều) tiếng reo hoan hô tiếng tung hô
acclamations	tiếng tung hôæklə''meiʃn/* danh từ- sự hoan hô nhiệt liệt=carried by acclamation+ thông qua bằng cách hoan hô=the decision was carried by acclamation+ mọi người vỗ tay hoan hô thông qua nghị quyết- ((thường) số nhiều) tiếng reo hoan hô tiếng tung hô
acclamatory	@acclamatory /ə''klæmətəri/* tính từ- hoan hô bằng cách nhiệt liệt hoan hô=acclamatory vote+ bầu bằng cách hoan hô
acclimatation	sự làm hợp thuỷ thổklaimə''teiʃn/ (acclimation) /æklai''meiʃn/* danh từ- sự thích nghi khí hậu sự làm hợp thuỷ thổ
acclimate	nghĩa hiếm) thích nghi khí hậu- thích nghi với môi trường làm hợp thuỷ thổ (súc vật cây cối)=to acclimatize oneself+ thích nghi với môi trường* nội động từ- (từ hiếmnghĩa hiếm) thích nghi khí hậu- thích nghi với môi trường
acclimation	sự làm hợp thuỷ thổklaimə''teiʃn/ (acclimation) /æklai''meiʃn/* danh từ- sự thích nghi khí hậu sự làm hợp thuỷ thổ
acclimatisation	sự làm hợp thuỷ thổ sự làm hợp thuỷ thổ
acclimatise	nghĩa hiếm) thích nghi khí hậu- thích nghi với môi trường làm hợp thuỷ thổ (súc vật cây cối)=to acclimatize oneself+ thích nghi với môi trường* nội động từ- (từ hiếmnghĩa hiếm) thích nghi khí hậu- thích nghi với môi trường
acclimatization	sự làm hợp thuỷ thổklaimə''teiʃn/ (acclimation) /æklai''meiʃn/* danh từ- sự thích nghi khí hậu sự làm hợp thuỷ thổ
acclimatizations	sự làm hợp thuỷ thổklaimə''teiʃn/ (acclimation) /æklai''meiʃn/* danh từ- sự thích nghi khí hậu sự làm hợp thuỷ thổ
acclimatize	nghĩa hiếm) thích nghi khí hậu- thích nghi với môi trường làm hợp thuỷ thổ (súc vật cây cối)=to acclimatize oneself+ thích nghi với môi trường* nội động từ- (từ hiếmnghĩa hiếm) thích nghi khí hậu- thích nghi với môi trường
acclimatized	nghĩa hiếm) thích nghi khí hậu- thích nghi với môi trường làm hợp thuỷ thổ (súc vật cây cối)=to acclimatize oneself+ thích nghi với môi trường* nội động từ- (từ hiếmnghĩa hiếm) thích nghi khí hậu- thích nghi với môi trường
sfs	sdfsd
sfdsf	fsdfsd
